above    以上、上面、上述
abreast	并肩、时髦的、及时了解
abroad	国外、室外
absent	缺席、不存在
abundance	丰富、充足
accents	口音、重要的问题
accepted	公认、被接受
accepting	验收、接受
accident	事故、意外
accommodated	容纳、适应
accompanied	伴随着、陪同
accomplished	已经完成、具有能力
according	根据、按照、依照
account	帐户、报告
accounted	占到、占据
accumulated	积累、积
ached	作痛、疼了
achieve	实现、取得
achieved	被实现
acknowledged	被承认、被认可
acquaintance	熟人、相识
across	横过、跨越
acted	采取行动、担任
acting	演戏、行事
action	行动、行为
actions	一些行动/行为
active	活跃、活泼
acts	行为、举止
acuteness	剧烈、严重
adaptability	适应性、适应能力
added	附加的、添加
adding	加入、添加
addition	添加、补充、加法
additional	额外、附加的
addressed	解决、写地址、面对
adjust	调整、调节
adjusting	调整、调节
adjustment	的调整/调节
administered	管理、实施
administering	管理、实施
administration	的管理、管理者
admiration	钦佩、敬佩、赞赏
adoration	的崇拜、的朝拜
adore	崇拜、爱慕
advance	推进、促进
advanced	先进的、高级的
advances	的进步、的进展
advantage	优点、优势、好处
advent	的到来、的问世
adventure	冒险、探险
adventures	的冒险
adversary	对手、敌手
advertised	广告、宣传
advertising	广告、宣传
advice	新闻、通知信、忠告
affair	事情、事故
affected	受影响的、有关的
affection	感情、慈爱、病情
affirmative	肯定的、确认的
affirmed	肯定、确认
afford	给予、力足以做
afoot	在进行、走路
afraid	怕、悸、害怕的
after	后、以后、然后
afternoon	下午、下午的
afterward	之后、后来、此后
again	再次、重新
againhalf	
against	"针对、抵抗、对着
 
"
agent	"代理人、经纪人、施事
 
"
ages	年龄、青睐
agility	"敏捷、灵活性
 
"
aglow	发红的、辐射的
agonizing	惨痛的、烦恼的
agony	痛苦、烦恼
ah	啊、  哎!
ahead	"向前、先头
 
"
aid	"帮助、协助、辅助
 
"
aimlessly	等闲
ain't	是不是、难道不是
air	空气、神气
air-holes	空气孔
aisles	过道、走道
akin	类似于、近似于
alaskan	阿拉斯加
alert	警惕的、的警报
alertness	"警觉、 机敏
 
"
alive	"活着、敏感的
 
"
all	所有的、的一切
allowed	允许的、容许的
allowing	允许、容许
almost	"几乎、差不多、将近
 
"
alone	单独、孤单
along	沿、顺
alongside	并肩、在。。。的旁边
aloud	大声地、高声
already	已经、曾经
also	也、还
alter	改变、修改、改造
always	总是、一直
amazingly	令人惊讶、令人惊异
ambition	志向、 意愿、志气
ambitious	"有雄心、抱负不凡的
 
"
ambuscade	伏击、埋伏
amenities	设施、厕所
amid	中、在。。。之中、在其间
ammunition	弹药、军火
among	其中、之间、在。。。之中
amongst	其中包括、当中、之间的
amount	"量、数量、等于、总共
 
"
an	一个
ancestor	祖先、祖辈
ancestors	祖先们
anchor	锚、碇、抛锚
ancient	古老的、过去的、古人
and	和、与、同
anger	愤怒、怒火、怒气
angle	角、角度、角落
angry	"愤怒、忿怒、忧郁
 
"
animal	动物、兽
animals	动物
animated	热烈的、扢的
ankle	"脚踝、 腿腕子
 
"
announced	公布、宣布
annoyed	恼火、懊
another	另一、别、在
answer	回答、答复、。。。的答案
answered	回答、解答
answering	回答、解答
answers	答案
antagonist	对手、敌手、对抗者
antagonists	拮抗剂
antlers	鹿角、觡
anxious	急、焦急、担心
any	任何、所有的
anything	什么、者、无论如何
anyway	无论如何、死活、还有
apart	隔开、离开、分别
apex	顶点、顶尖
appalled	"震惊、慴
 
"
apparel	服饰、 穿戴
apparent	"明显的、 表面的
 
"
apparently	"似乎、显然地、表面上
 
"
appealed	呼吁、上诉
appealingly	恳求、吸引人地
appear	出现、呈现、显露
appearance	外形、外貌
appeared	出现、显现
appeasement	缓和、 抚慰
approvingly	赞许地、 满意地
appetites	胃口、口腹之欲
apprehension	"顾虑、忧心、拘押
 
"
apprehensions	忧虑、疑虑
apprehensively	悬念、忧虑地
approached	走近、接近
apt	贴切、合适、得当
arbors	乔木、心轴
arctic	北极
arduous	艰巨、艰苦、费力的
are	是
aristocrat	贵族、贵族论者
arm	胳膊、胳臂
armed	武装的、武警
arms	武器、军火、军备
arose	出现、产生
around	周围、围绕、在。。。周围
arouse	"引起、唤起、激起
 
"
aroused	激昂、引起了
arranged	安排、配置
arrangement	安排、排列、布局
array	"排列、矩阵
 
"
arrested	拘捕了、被捕
arrive	"到达、抵达、来到
 
"
arrived	抵达 了、来到 了
arrow	箭头、箭
arrow-end	箭头
arrows	箭头
art	艺术、美术、功夫
artesian	"自流井的、喷水井的
 
"
article	文章、条文、报道
articles	用品、文章
articulate	明白地说、说出
artist	艺术家、画家、美术家
as	如、如同、若
ascended	登高、升天
ashamed	"羞愧、过意不去的
 
"
ashore	"岸上、向岸地
 
"
aside	旁白、在旁边
ask	问、询问、请求
asked	问、询问
asleep	"睡着的、麻木的
 
"
aspect	"方面、侧面
 
"
aspens	白杨
aspired	渴望、期望
assailants	袭击者、行凶者
assailed	抨击、袭击
association	"协会、组合、合伙
 
"
assortment	"品种、花色品种
 
"
astonished	惊讶、吓坏的
astonishment	惊愕、惊异
asunder	四分五裂、崩裂
at	在、于、对
ate	吃了、吃掉
athletic	"运动、田径的
 
"
atmosphere	气氛、 大气层、空气
attached	"附、 附属、隶
 
"
attack	"攻击、进攻
 
"
attacked	攻击、袭击
attacking	攻击、袭击
attempt	"尝试、企图、试图
 
"
attempted	"尝试、试图
 
"
attempting	试图、尝试
attended	出席、参加
attention	注意、关注
attitude	态度、姿态
attracted	吸引、引起
aurora	极光
authority	权威、威权、权柄
avail	"利用、裨益
 
"
averaged	平均、场均
averred	断言、坚称
avoided	避免
awakening	唤醒、唤醒的
awakenings	觉醒、憋醒
aware	"察觉、注意到、自觉
 
"
away	远离、缺席的
awe	威严、贺词、恐吓
awed	慑于、镇住了
awkward	尴尬、笨拙
awoke	醒了、点醒
axe	"斧头、 钺
"
axe-handle	斧头柄
babel	巴贝尔、通天
back	后面、背面
backbone	"骨干、支柱
 
"
backed	支持、抵押
backs	背上、后背
backward	"落后、向后的
 
"
bacon	熏肉、咸肉
bad	坏、不良、糟糕
badly	惨、 非常
bag	袋、 包、兜子
baggage	行李、包袱
baggageman	baggageman
bags	一些袋、一些包
ball	球、舞会
band	带、带子、 钮带
bank	"银行、岸边
 
"
banked	开户、存入银行
bar	酒吧、酒廊、沙洲
barbarous	"野蛮、 残暴、 禽兽
 
"
bare	"裸、赤裸裸、 裸露
 
"
barely	仅仅、刚
barge	"驳船、 游艇
 
"
bark	吠、喊叫
barked	咆哮、吠叫
barking	叫声、叫声的
barracks	军营、兵营
barred	禁止、不得
barrens	贫瘠之地、不毛之地
bars	几家酒吧、几家酒廊、沙洲
basis	"基础、依据、根据
 
"
batches	批次、分批
bathed	沐浴、洗澡
battered	焦头烂额
battering	殴打、虐打
battle	战斗、开战、的斗争
battles	战斗、闯荡
battle-scarred	身经百战
bay	海湾、 绝路
be	是、在、有、为
beach	海滩、岸边
beaches	海滩、泳滩
bear	承担、承受、背负
beardless	无须、乳臭未干
bearing	轴承、风度、态度
beast	"兽、走兽
 
"
beasts	兽类
beaten	殴打、破败、疲惫
beating	"跳动、搏
 
"
beautiful	美丽、漂亮
beaver	"海狸、 河狸
 
"
became	成为、变成
because	因为、因、由于
beckon	招手、摆手
become	成为、变成
becomes	成为、变成
becoming	成为、变成
bed	"床、床铺
 
"
bedlam	疯人院、喧闹
bed-rock	基岩
beds	"床、床铺
 
"
been	一直、已经
before	前、以前、从前
began	开始、始于
begged	求、恳求
beginning	"开始、开头、初期
 
"
beginnings	开始、开头、开端
behind	背后、落后、的后面、在。。。后边
being	存在、生存、存在的
belie	谗、谤
belief	"信念、信仰、信心
 
"
believed	相信、信
believing	相信、认为
belligerent	"交战的、交战的双方、 忮
 
"
bells	钟声、铃铛
belly	肚皮、肚子、腹部
bellying	Bellying
belong	属于、附属
belonged	属于、所属
belongings	财物、财产
belongs	属于、所属的
below	下面、一下、在。。。之下
belt	带、腰带、带子
bench	长椅、长凳
benches	长凳、长椅
bend	弯曲、摇动、。。。的弯子
bending	弯曲、摇动
bends	弯曲、摇动、。。。的弯头
beneath	下面、底下、在。。。之下
bent	"弯曲、搞同性恋的、爱好、志向
 
"
berry	浆果、野果
beset	困、向往
besetting	困扰、倒退
beside	旁、和。。。相比、在。。。之旁
besides	除了、此外、另外
bespeak	预示着、表明
best	最好的、最好的东西
bet	"打赌、赌钱
 
"
betrayed	背叛、出卖
better	更好、优越
between	之间、中间、在。。。之间
bewildered	"惶惑、荧
 
"
beyond	外、在远处、在。。。以外
bickered	斗嘴、吵嘴
bickering	争吵、斗嘴、口水仗
bid	出价、 投标
bide	待机、 居住
big	大、壮大、伟大
bill	法案、帐单、票据
birch	"桦木、桦树
 
"
bird	鸟、雀
birds	鸟类、兽类
bit	"块、辅币、点滴
 
"
bite	"咬、叮、的咬伤
 
"
bites	"咬伤、咬钩
 
"
biting	"尖刻、 刺激的、刻薄的
 
"
bitten	被咬、咬伤
bitter	"苦、惨痛、的酸溜溜
 
"
bitterness	苦、苦味
black	黑色、墨
black-faced	黑面、黑脸
blanked	空白、消隐
blankets	毯子、毛毯、被子
blaze	火灾、失火、火焰
blazed	闪耀、熟
blazing	"炽烈、炽热、炽灼
 

 
"
bleak	"苍凉、严峻、萧条
 
"
bleeding	流血的、放血的、渗色
blew	自爆、炸毁
blind	盲人、瞎子
blinded	失明、蒙蔽
blinding	致盲、盲法
blinking	闪烁、眨眼
blizzards	暴风雪、特大雪灾
blocked	受阻、阻塞
blocking	"闭塞、的拥塞
 
"
blood	血、血液
bloodhound	猎犬、警犬
blood-longing	血向往、渴望
blood-shot	布满血丝、血丝
bloody	血腥、残忍、要命
blow	吹、 喘吁吁、打击
blowing	吹、吹制
blows	打击、的冲击
blue	蓝色、青色、郁闷
bluff	虚张声势、断崖、绝壁、直率的
blundered	失蹄
blunderer	blunderer
blundering	浮躁、弄巧反拙
boast	夸、吹牛、说大话、自诩
boastful	嘐、自夸
boat	船、航船
boats	船、航船
boded	预示、兆头
bodies	机构、团体
bodily	身体、人身
body	"身体、机身、机关
 
"
boldest	最大胆、最为大胆
boldly	大胆、勇敢
bologna	博洛尼亚、腊肠
bolted	狂奔、螺栓连接
bombarded	炮轰、轰炸
bonanza	富矿带、昌盛、成功
bone	骨、骨头
bones	骨头、骨
bony	"骨的、 干瘦
 
"
book	书、本子、册子、著作
boomed	蓬勃发展、兴旺、发飙
booming	繁荣、有成就的
bore	"烦扰、的凿孔
 
"
borealis	北极光、北欧化工
bored	"无聊、腻烦、烦人的
 
"
born	天生的、生来的
borne	承担、负担、承受
boss	老板、经理、头子
both	两、双、俩
bottom	底部、底子、最后的
bottom's	底部、底面
boughs	树枝、枝子上搭
bought	"买、牛圈、
 
"
bound	界、范围
bounded	界、有界
boundless	苍茫、漫漫、苍莽
boxes	箱、盒、框
boy	男孩、童
boys	男孩们、哥儿
braced	支撑、掺进
bragged	吹嘘、自夸、大言不惭
brain	脑、击碎 ... 的脑袋
branching	"分枝、 发枝的
 
"
brass	"黄铜、镀以黄铜
 
"
bravely	勇敢、奋勇
bravery	胆、华饰
bravest	勇敢
bread	面包、生计
break	打破、打断
breakable	易碎的、可破坏
breakfast	早餐、早饭
breaking	破坏、阻断
breaks	休息、断裂
break-up	分手、解体
breast	"乳房、以胸对着
 
"
breast-band	乳房波段
breast-bands	母乳带
breath	气息、鼻息
breathe	"呼吸、 换气
 
"
breathed	无声、浊
breathing	呼吸
breathless	气喘吁吁、气喘喘
breaths	呼吸、次呼吸
bred	育成、木板
breed	品种、树种、培育
breeze	微风、 煤屑
breezes	海风、微风
brewing	"酿造、混合
 
"
bribe	贿赂、贿络、饵
bridges	桥梁、桥接器
brief	简要、简短、短暂
bright	明亮的、光明、爽朗
bring	"带来、拿来
 
"
bringing	使、引进
bristled	毛、发怒
bristling	"林立的、竖立的
 
"
broad	广阔、宽阔
broad-breasted	广泛排扣
broader	更广泛
broke	"爆发、断掉、一文不明的
 
"
broken	破、残破
broken-heartedly	伤怀、伤心
brooded	反复思量、开始思考
brooding	忧郁、多思考的
brooms	扫帚、扫把
brother	哥哥、挚友、修士
brother-in-law	"姐夫、表兄弟、妹夫
 
"
brothers	"兄弟、手足、 哥儿们
 
"
brought	带来
brown	"棕色、褐色、成褐色
 
"
browse	浏览、 放牧、翻阅
bruise	挫伤、青肿、擦伤
bruised	伤痕累累、压伤
bruises	跌打损伤、瘀伤
brumal	brumal
brutal	残酷、野蛮、残暴
brutality	残酷、 肆虐、兽行
brutes	畜生！、畜生
bubbled	冒泡、鼓泡
bubbling	冒泡、鼓泡、起泡
bucked	逆市上扬、顶住
buckled	沉着应战、披挂上阵
buckles	扣、带扣
budge	让步、不为所动
buds	芽、花蕾
build	建立、建设、修建
building	建筑、大厦、营造物
built	建、建造
bulging	鼓鼓、膨出
bulk	体积、大批、膨胀
bulked	膨体、膨化
bull	公牛、牯牛、 粗壮如牛的
bulls	公牛、公牛队
bull's	公牛的
bully	"欺负、欺压、锦绣的
 
"
bunched	揉成、成束
bundle	束、包裹、捆
bundled	捆绑、绑定
bundles	束、捆绑
buried	隐藏、 湮
burned	烧毁、烧掉
burning	燃烧、烧灼
burst	爆裂、破裂
bursting	爆破、破灭
business	业务、商业、生意
businesslike	公事公办
busy	忙、忙碌、繁忙
but	但、不过
butt	屁股、臀部
butter	黄油、奶油
by	由
cabin	机舱、客舱
cadences	节奏、韵律
cagelike	笼状、笼形
cajole	"谄、 哄骗、 勾引
 
"
calamity	灾难、灾害、 大祸
calculated	计算
calculating	计算，运算
calf	小牛
call	被称为，叫
called	被称为，叫
calling	调用，感召
callous	冷酷， 趼
callousness	麻木不仁
calm	平静，冷静
calmly	平心静气， 舒服
calves	小牛，牛犊
came	来，来到
camp	营，阵营
camped	扎营，风餐露宿
camping	露营，野营
camps	阵营，营
can	可以，可
candle	蜡烛，烛
canned	罐头，听装
cannot	不能，不得
can't	不能，无法
canvas	帆布，画布
cap	帽，帽子
capable	能，能力
capacity	容量，量
capital	资本，倾覆
capsized	翻船、倾覆
captain	队长、 船长
car	"汽车、轿车、车厢
 
"
carcass	胴体、胎体
carcasses	尸体、屠体
care	关心、在乎、在乎
cared	关心、照顾
careful	小心、仔细、谨慎
carefully	小心、精心
caress	摩挲、爱抚
caressing	爱抚、轻抚着
carnivorous	肉食的、食肉
carried	进行、携带
carry	携带、搬运
carrying	携带、账面
carted	好不容易把、用车运送
cartridges	墨盒、硒鼓
case	案件、外壳
cash	现金、现款、兑现
cast	投、撒、的铸件
cat	猫、恶妇
catching	追赶、捕捉
cat-footed	猫足
catlike	猫爪、像猫
cattlemen	牧牛、牧畜
caught	抓、捉住
cause	导致、引起、的原因
caused	造成、引起
caution	警告、保守、警告
cautious	谨慎、审慎、拘谨
cautiously	谨慎、翼翼
cave-dweller	洞穴居民
cayuses	cayuses
ceased	停止、不再、终止
celerity	当机立断、波速
cell	细胞、元件、牢房
cement	水泥、接合剂、粘牢
centre	中心、中央、集中
centring	定心
centuries	几个世纪、世纪以来
certain	某些、一定、确定
certainly	当然、的确
certainty	肯定、把握、某几个
certitude	确定性、确实性
cessation	戒烟
chaff	糠、秕糠、戏弄
chaffering	chaffering
chafing	气恼、摩擦、皮肤发炎
chain	链、连锁、锁链、束缚
challenging	具有挑战性的、充满挑战性
champion	冠军、优胜者、冠军的
chance	机会、偶然、运气、发生
chanced	一次偶然的机会、巧遇
chances	机会
change	改变、变化、变动
changed	变、换车
changing	改变、变化的
channel	渠道、航道、引导
chant	呗、高唱、歌谣
chaotic	混乱、乱纷纷
chapter	章、章节、分会
characterized	特点、特征
charge	充、冲锋、记帐、收费
charged	带电、可充电
chase	追、迹、狩猎
chasm	裂口、断层、裂痕
chattered	喋喋不休、格格作响
chattering	热热闹闹、喋喋不休
cheaper	便宜
check	查、遏制、校验
checked	检查、选中
cheek	脸颊、胆大妄为、放肆
cheeks	两颊、脸颊
cheer	欢呼、喝采、打起精神
cheerful	快乐、愉快、爽快
cheering	欢呼
cheery	愉快的
chemically	化学
cherished	珍惜、珍爱的
chest	胸部、胸膛、寿材
chests	胸前、胸膛
chew	咀嚼、嚼、咀爵食物
chewed	咀嚼、嚼过
chief	首席、长官、领袖
child	孩子、儿童
children	孩子们
chill	寒意、寒气、凉飕飕
chinese	中国的、中国话的、汉语
chinked	CHINKED
chipmunks	花栗鼠、金花鼠
chivalrous	骑士的、义
chivalrously	骑士
choke	呛、窒息、阻塞
choked	哽咽、淤塞
choking	窒息的、哽
chook	Chook
chop	砍、官印、商标
chopping	搓球、遽变的
chops	印章、脸颊
chorus	合唱团、合唱
chosen	选择、精选
chronic	慢性病、长期的
chuckling	笑着、吃吃的笑
chunk	块、数据块
chunks	块、数据块
churned	搅动、翻腾
churning	搅动、翻腾
circle	圈、循环、盘旋
circled	盘旋、圆圈
circles	界
circling	盘旋、转圈
cities	城市
citizens	公民、市民
city	城市
civilization	文明、文化
civilized	文明的、有礼的
civilizing	文明、文明化
claims	索赔、索偿
clamor	叫嚣、喧、叫嚷
clannish	氏族、宗族
clara	圣克拉拉
clash	冲突、抵触、铮铮
clashed	发生冲突、爆发冲突、打击
clasped	紧握、合十
claws	爪、利爪
clean	清洁、干净、打扫
cleaned	清洗、清理
cleanly	干净、干净利索
cleansed	洁净、清洗
clear	清除、表明、明显
cleared	清除、清零
clearing	清除、空地
clearly	明确地、分明、逼真
clenching	紧握、咬牙
clerks	科员、文员
clever	聪明、高明、乖巧
cliff	悬崖、峭壁
climbed	攀升、爬上
climes	气候
clinching	铆、紧抓住
cling	依偎、贪恋、固执
clinging	抱住、扒着
clip	夹、修剪、缩减
clipped	裁剪、发音清楚的、省略一部分的
clipping	剪裁、剪毛、快速的
close	关闭、封闭、密切
closed	关闭、合拢的
closely	密切、留心地
closer	接近、更接近
closing	关闭、收盘
clothes-bags	衣服袋
clothes-sack	麻袋衣服
cloud	云、霄、使 ... 忧郁
club	俱乐部、棍棒、用棍棒打
clubbed	杵状、棒状
clubbing	泡吧、杵状
clubs	俱乐部、会所
clung	抱定、固守
clutched	攥、抓住
clutching	捂着、抓着
coals	煤、炭火
coat	外套、涂层、焊药
coated	涂、包覆
coats	大衣、外套
cock	公鸡、雄鸡、干草垛、举起
code	码、法规、略码
coils	线圈、盘管
cold	冷、凉、寒冷
colder	更冷、寒冷的
coldly	冷眼、不亲热地
cold-tubbing	冷澡
collar	领、颈间、攫取
collected	集、有自制力的
college	学院、院
comb	梳、蜂巢、篦
combatants	战斗、战斗员
combined	结合、合计的
come	来、发生
comes	来自、自带
comfortable	自在、安逸、爽快
comfortably	舒服、方便、合适
coming	未来、过来
command	命令、指令、控制
commanded	吩咐、指挥
commence	开始、着手、发源
commented	评论、评价
commingled	混合、合采
common	常见、普通、常规
communicated	沟通、传达、通信
communion	交往、交谊、往来
compact	紧凑、凝练、粉盒
compactly	紧凑地、简洁地
companies	公司、企业
companion	伴侣、同伴、伴随
company	公司、企业
comparatively	比较、相对
compared	相比、比较
compass	指南针、罗盘、包围、半圆形的
compel	强迫、迫使、逼迫
compelled	被迫、迫使
compellingly	令人信服、使人非相信不可
complained	抱怨、埋怨
complete	完成、完整、齐全
completely	全然、十分、统统
completeness	完整性、完备
complied	遵守、符合
comprehend	理解、领会、理会
comprehension	理解、合理
comprehensively	全面、综合
compressed	压缩、密集
computation	计算、预算
comrade	同志、同伴
comradely	同志
comrades	同志、俦
comradeship	谊、战友情谊
concealed	隐、暗
concealment	隐蔽、躲藏
concerned	关心、忧虑
concerning	关于、关於
conciliate	怀柔、靖
conciliated	调解、和解
conclusively	决定性、确凿
concrete	具体、实际
condition	条件、状态、境况
conditions	条件
conduct	进行、举办、行为
confessed	公然的、所公认的、公开的
confidence	信心、信任、信赖
confidently	自信、满怀信心
confined	坐困、隘
confines	局限、界限
confused	困惑、迷茫、乱糟糟
confusion	混乱、迷乱、爽然
congested	拥挤、拥堵
conjuration	咒语、召唤系法术
conscious	意识、察觉、自觉
consideration	考虑、计算、和蔼
considered	考虑、敬爱的、斟
considering	考虑、就 ... 而言、总之
consignment	寄售、寄出、托运物
conspicuous	显着、触目、显著
constant	不变、常量、不断
constantly	经常、时刻、一向
consternation	惊愕、发呆
consultation	会诊、参考、谘询
contact	联系、接触、交往
contagion	传染性、腐化
contained	包含、所含
contemplate	沉思、注视、思虑
contemplation	沉思、禅
contend	抗衡、角逐、周旋
contended	争辩、辩称
content	内容、含量、满足
contents	内容、篇目
continent	大陆、镇静的
continual	持续、不断
continually	不断、谆谆
continued	持续、经久
continuous	连续、连绵
contracted	签约、简约的
contraption	玩意儿、精巧
contribution	贡献、捐助、汗马功劳
control	控制、治理、管制
convalescence	恢复期
conversation	谈话、会谈
conveyance	运输、运输工具
convulsed	忍俊不禁、抽搐
convulsive	抽搐的、抽筋的
cook	煮、烹饪、厨师
cooking	烹饪、烹
cooks	厨师、烹调
cool	凉爽、冷静、镇、凉丝丝
coolly	冷静、冷淡
copies	副本、拷贝
copious	丰富、丰厚、广识的
corner	角落、垄断贩卖
cornered	走投无路、狗急跳墙
cottages	小屋、村舍
could	可以、可能
couldn't	不能
count	算、统计、详述
counted	计数、计入、算作
countered	反驳、反击、抵消
countless	无数、数不清、不可胜数
country	国家、江山、本土
couple	一对、俪、挂钩
courier	信使
course	课程、进程、航道
cousins	表兄弟、堂兄弟
cover	覆盖、掩护
covered	覆盖、湮
coverings	覆盖、铺面
covert	隐蔽、隐秘、隐藏处
coveted	令人垂涎、觊觎的
cows	奶牛、头奶牛
crack	裂纹、裂缝、崩裂
cracked	破获、发疯、精锐
crackled	噼啪作响
crackling	噼里啪啦
craftily	诡诈地、狡猾
crashed	坠毁、崩溃
crashing	崩溃、非凡的
crate	箱、板条箱
craters	陨石坑、环形山
crates	板条箱、条板箱
crawl	爬、自由泳、匍
crawled	爬、抓取
crawling	爬行、抓取
crazed	疯狂、发疯
creature	生物
creatures	生物
credit	信用、信誉、信任
creek	溪、汜、澥
creep	爬、蔓延
creeping	爬行、蔓延的
crept	蹑手蹑脚、爬行
crest	波峰、鸡冠、加以顶饰
crickets	蟋蟀、蛐蛐
cried	哭了、叫道
crippled	跛、废
crisp	脆、毳、弄卷
cross	交叉、横过、十字架
crossed	越过、横渡
crosses	跨越、越过
crossing	路口、渡口、横断
crouch	蹲伏、蹲、卧
crouched	蹲在、蹲伏
crouching	蹲伏、蜷缩
crowd	人群、一群、丛集
crowded	挤、稠、沓
crowed	乐得合不拢嘴、群众里去
cruelly	残酷、得够呛
crumb	屑、捏碎、残羹剩饭
crumpled	皱巴巴、弄皱、揉成一团
crunch	紧缩、危机、短缺
crunched	嘎吱嘎吱、嘎吱作响
crushing	破碎、粉碎
crushingly	毁灭性的、打破
cry	哭、喊叫、垂泪、呼声
crying	哭、喊叫、垂泪
cue	球杆、暗示、隐射
culprit	罪魁祸首、元凶、祸首
culprits	匪徒、贼人
cunning	狡猾、狡诈、诡诈
cunningly	狡猾、巧妙地
cure	治愈、治疗、纠正
curiously	好奇、奇怪
curled	卷曲、蜷缩
current	当前、现时、潮流
curse	诅咒、经期、咒骂
cursed	诅咒、大骂
curses	诅咒、咒骂
cursing	咒骂、诅咒
curved	弯曲、瞎、钩状的
curving	弯曲、弧形
custom	习俗、习惯、惯例
customary	习惯性、惯常的
cut	切、截
cuts	削减、割伤
cutting	切割、插条、尖利的
dainty	纤巧、楚楚、馔
dam	坝、母畜、堨
damnation	诅咒、詈、诅
dams	水坝、堤坝
dance	跳舞、舞会、舞蹈
dancing	舞蹈、婆娑
danger	危险、患、岌
dangerous	危险的、悬、陧
dared	敢、胆敢
dark	黑暗、深、晦
darkness	黑暗、隐晦
darted	飞奔、冲出
dash	短跑、冲撞、冲劲儿
dashed	虚线、非常
daughters	女儿们
daunted	吓倒、气馁
dawn	黎明、破晓
day	日、天
daybreak	黎明、拂晓、昕
days	天、日
days'	天
day's	天的
dazed	迷茫、迷糊
de	去、德
dead	死、过世、僵死
dead-tiredness	死疲劳
deaf	聋、聩、耳聋
deal	处理、合同、经销
dealers	经销商、交易商
dealt	处理、买卖
dears	亲爱的、对逗人
death	死亡、死命
deathless	不死、不朽
death-struggle	死亡斗争
debts	债务、拨备
decay	衰变、腐烂、衰败
deceit	谎言、骗局、玄虚
december	十二月
decided	决定、确定
decidedly	断然地、果断地
decivilization	decivilization
deck	甲板、舱面
deeds	事迹、契据
deep	深、深厚
deeper	更深
deeps	深渊、涧深渊
deer	鹿
deerhound	猎鹿、猎鹿犬
defence	防御、防务
defend	辩护、捍卫
defended	辩护、保卫
defending	卫冕、防御
defiance	蔑视、反抗
defiantly	对抗地、挑衅
defied	无视、违抗、藐视
definite	确定
deft	麻利、灵巧
defying	玩命、不畏
dejected	垂头丧气、黯然
delay	延迟、拖延、耽搁
delayed	延迟、拖延、耽搁
deliberately	故意、有意、偏偏
deliberateness	蓄意
delight	喜、情趣、趣味
delights	喜悦、佳肴
deliver	交付、传递、发表
deluged	淹没、泛滥
demand	需求、需要
demanded	要求、需要
demanding	严格、严
demesne	私有、自营
demon	恶魔、魔鬼、鬼蜮
demonstrative	示范、说明的
den	巢穴、窝
denied	否认、拒绝
depart	离开、背离、放弃
departed	过去的、过世的、死者
departs	离开、离去、起程
departure	出发、离开
depending	根据、视乎
deposited	沉积、存放
deposits	存款、按金
depot	仓库、车站
depths	深处、深度
descend	降落、下去
descended	后裔、下降
descent	降落、侵袭
described	描述、所述的
description	描述、描写
deserted	废弃的、寞、廖
deserved	应得、实至名归
desire	欲望、愿望、想望
desired	所需、期望
desires	欲望、私欲
desolated	荒凉、荒芜
despatches	急件、寄发
desperate	危急、殊死
desperately	拼命地、没命
desperation	绝望、拼命、精神错乱
despise	鄙视、轻视、嗤之以鼻
despite	尽管、虽然、任凭
destined	注定的
destroy	破坏、摧毁、毁灭、残
destroyed	销毁、破坏、摧毁、毁灭
destroying	摧毁、破坏、击破
destruction	毁坏、拆毁、拆卸
detail	细节、详情、枝节
details	详细信息
detection	发现、检测
determined	决心、坚决
determining	确定、决定
detestable	可恨、可恶
developed	发达、开发
development	发育、开展、养殖
devil	魔鬼、死鬼
devils	鬼子、魔鬼
devotion	忠诚、忠心
devoured	吞噬、烧灭
diabolically	恶魔般地、像魔法般
dictate	主宰、听写、指挥
dictating	口述、听写
did	做、确实
die	死、去世、逝世
died	死亡、去世
diet	饮食、营养、忌口
different	不同、迳庭、和 ... 不同
difficult	困难、艰难、严峻
dig	挖、掏、发掘
digestions	消化、酶切
digging	挖、挖坑
dignified	端庄、凝重、俨然
dignity	尊严、体面、威严
dim	暗淡、黯淡、幽暗
diminished	减少、减退
dimly	依稀、朦胧、恍惚
dimmed	变暗、黯淡
din	吵闹、豗
dinner	晚餐、请客
directing	指导、指挥
direction	方向、指导、针对性
directions	方向、说明
directly	直接、直截了当地
directness	直接、笔直
dirt	污垢、灰尘、泥土
dirty	脏、秽、变脏
disappear	消失、遁、澌灭
disappeared	消失、失踪
disappearing	消失
disaster	灾难、灾害、 大祸
disburdened	disburdened
discarded	丢弃、废弃、舍弃
discharged	出院、放行
discharging	放电、排放
discipline	纪律、规律、惩戒
disciplining	管教、纪律
disclosed	披露
discolored	脱色的
discomfited	扰乱、狼狈
discomfiture	尴尬、狼狈相
disconsolate	悲、悲伤
discover	发现、暴露
discovered	发现
discovery	发现
disgust	厌恶、嫌恶、厌恨
dishes	碗碟
dismay	沮丧、吓住
disorder	紊乱、毛病、搅乱
displaced	流离失所、位移
displeasure	不满意、不愉快
dispute	争议、纠纷
disrupted	打乱、破坏
distance	距离、路程
distant	遥远、远端
distinct	不同、分明
distributed	分布、分发
divers	潜水员、潜水者
divide	划分、分裂
divides	划分、瓜分
divined	占卦、猜到
do	做、进行、欺诈
docilely	温顺、驯服
doctor	医生、大夫、行医
dodge	闪避、躲避、避讳
dodged	躲过、躲闪
dog	狗、跟踪
dog-busters	狗的主力部队
dog-doctor	狗的医生
dog-driver	狗的驱动程序
dog-food	狗的食物
dogged	誓不罢休
dogs	狗
dogs'	犬
dog-teams	狗队
doing	干、活动
dollar	美元
dollars	美元
domesticated	家、驯化
dominant	优势、主导、统治
dominion	主权、领土、领地
done	完成、做过
don't	别、禁忌
doom	厄运、死命、注定
door	门、户
doors	门
dose	剂量、服用量、服药
dot	点、嫁妆、加小点于
doubled	一倍、翻番
doubling	加倍、翻一番
doubt	怀疑、疑问
down	下、击落、绒毛
down-coming	下未来
downhill	下坡、向下
down-stream	下游
downward	向下、向下的
dozen	打、十二
dozing	打瞌睡、推土作业
drag	拖动、拖累、揪
dragged	拖、拖累
dragging	拖延、拖延的
bedraggled	全身湿透
drainage	引流、排水渠
drank	喝了、喝下
draped	搭着、披着
draught	草案、草拟
draw	画、绘画、平局
drawing	绘画、图纸、图样
drawn	画、拔出的
dream	梦想、梦幻、梦见
dreamed	梦想、梦到
dreamily	朦胧地、梦幻般地
dreaming	做梦、梦想着
dreams	梦想
dreary	沉闷的、凄凉
drew	提请、吸引
dried	干燥、干的
drift	漂移、漂流、浮动
drifted	漂流、飘然
drifting	漂流、流
driftwood	浮木、漂流木
drink	喝、醉、饮料
dripping	滴水、淋漓
drive	驱动、驾驶、驾车
driven	驱动、受到驱策的
driver	司机、螺丝刀、开车人
drivers	驱动程序、司机
drives	驱动器、磁碟机
driveways	车道、行车道
driving	主动、赶、操纵
drooped	下垂、耷拉下来
drooping	下垂、低垂
drop	下降、滴
dropped	下降、丢弃
dropping	落下、滴下
drove	开车、畜群、噳
drowned	淹死的、没
drumming	鼓声、鸣
dry	干、旱田、槁
dub	配音、鼓声
dubiously	怀疑地、半信半疑
dug	挖
dull	平淡、枯燥、钝
dumped	倾倒、转储
duplicated	复制、重复
during	中、在 ... 期间
dust	灰尘、尘埃、掸
duties	职责、义务
duty	责任、关税
dwelling	住宅、居所、寓所
dwindled	萎缩、缩减
dying	垂死、不行了
dynasty	王朝、朝代
each	每、各自、皆
eager	急于、踊跃、殷
eager-eyed	渴望的眼睛
eagerly	眼巴巴、踊跃、如饥似渴
eagerness	热心、兴
ear	耳、棒子、抽穗
earlier	早期
early	早、先
earned	赚
earnest	认真、恳切、惓
ears	耳朵
earth	土、泥土、培土
ease	缓解、减轻、悠闲
easier	更容易
easily	容易、顺手、松快
east	东方
easy	容易、轻而易举
eat	吃、喝汤、啗
eatable	食用
eaten	吃了
eater	吃的人、侵蚀物
eating	吃、食物、腐蚀性的
ebb	落潮、衰退
ebbed	消退、退至
economy	经济、撙节
ecstasy	狂喜、发迷
eddies	漩涡、涡旋
eddy	涡流、涡水
edge	边缘、锋、镶
eerie	怪异、诡、怪诞的
effectually	有效地
effort	功夫、成就、气力
efforts	努力、力度
egotistical	自负、自私的
eh	啊
eight	八、捌
eighteen	十八
either	或、二者之一、任一
elbows	手肘、肘部
electric	电动、电气
elimination	消除、肃清、排斥
eloquent	雄辩、佞
eloquently	雄辩、雄辩滔滔
else	其他、否则、别地
embrace	拥抱、怀抱
embracing	拥抱、相拥
emptied	清空、掏空
emptiness	空虚
enable	使、使 ... 能够
enabled	启用、使能
encountered	遇到、中遇到
encourage	鼓励、提倡、打气
encouraged	鼓励、鼓舞
encouragement	鼓励、靠山
encouraging	鼓励、奖励的
end	结束、末尾
ended	截至、截止
ending	结束、终端
endless	无穷、漫长、广大无边
ends	结束、两端
endured	忍着、忍受
enemy	敌人、寇仇
enemy's	敌人的
enforce	执行、强制
enforcing	执行、强制
english	英语
enormous	巨大、庞大、硕大无朋
enormousness	enormousness
enough	足够、充足、彀
enter	进入、输入
entered	进入、订立
enthusiastically	踊跃、热情地
enticed	诱惑、引诱
entreated	恳求、凌辱
enveloped	笼罩、包膜
enveloping	包络、包绕
environment	环境、周围
equal	等于、相等、匹敌
equally	一样、相等
equilibrium	平衡、平静
ere	ERE
erect	竖立、直立的
errands	跑腿、差事
error	错误、偏差
escape	逃生、溜走
escaped	逃脱、躲过
escorted	护送、护航
especial	尤其是、特别是
especially	尤其、特别、异常
essential	必要、要点
estimation	预算、意见
eternal	永恒、永存
eternity	永恒、永远
even	甚至、偶数、相等
evening	黄昏、晚间、残照
events	事件、赛事
ever	曾经、尝、多会儿
every	所有的、凡是
everybody	每个人、诸
everything	一切、万事
everywhere	到处、随地、广泛地
evidenced	证明、证实
evident	明显、昭著、彰
evil	邪恶、坏事
evil-looking	邪恶的前瞻性
evil-tempered	邪恶的脾气
evinced	明证
examined	检查、审查
examining	检查、研究
excelled	出色、擅长
excellent	优秀、卓越、高超
except	除、除了 ... 之外、反对
exception	例外、反驳、不赞同
excess	多余的、过量、过度
excessive	过多、赘
exchanged	交换、兑换
excited	兴奋、对 ... 感到兴奋
excitedly	勃然、踊跃
excitement	激动、起浪
exclaim	喊叫、呵
exclamations	感叹词、惊叹
excrescence	赘生物
exertion	用力、发挥、紧张
exhausted	筋疲力尽、枯竭、阑
exhausting	辛苦、累人的
exist	存在、是
existence	存在、生存
expectant	准、待产
expected	预期、有望
expecting	期待、有喜
expediency	便利、合理性
experience	经验、经受
experienced	有经验、熟习
experiment	实验、试验
exploit	利用、伟业
express	特快、表示
expressed	表达、表现
expressing	表达、表示
expression	表达、神情、劲
exquisite	玲珑、绝妙、精美的人
external	外部、外面
extinct	灭绝的、过世的、已灭
extracted	提取、摘录
extreme	极端、偏激
extremity	端、末端
exultantly	眉飞色舞、得意扬扬
eye	眼、细看
eyes	眼睛
fabled	传说中的、寓言中的
face	面对、面孔
faced	面临、面临
facing	面对、外面、覆盖层
fact	事实、景况
facts	事实、真情
fading	衰退、衰老
fail	失败、辜负
failed	失败、故障
failing	错误、因为缺乏、缺少的
fails	失败、未能
faint	昏、微弱、晕倒
fainter	昏暗的
faintest	微弱、最暗
faintly	依稀、恍惚、朦胧地
fair	公平、博览会
fairly	相当、比较
faith	信仰、信用
faithful	忠实、忠诚
faithfully	忠实、忠诚地
faithfulness	忠诚、忠心
fall	下降、秋季
fallen	下降、倒下
falling	落下、落的
fame	名誉、声誉、使 ... 驰名
familiar	熟悉、挚友
familiarity	熟悉、放肆的言行
family	家庭、家族、僚属
famine	饥荒、饥馑
famished	惄、馁
fang	方、方舟子
fanged	毒牙、獠牙
fangs	獠牙、毒牙
fanned	煽动、散开
far	远、遥
fare	票价、旅行
fared	表现、混得
farther	更远、以后
farthest	最远
fashion	时尚、塑造
fashions	时尚、流行款式
fast	快、绝食
fastened	固定、紧固
faster	快
fastidiousness	一丝不苟、精致
fat	脂肪、肥、膏
fatal	致命、必然的
fateful	致命的、灾难性
father	父亲、发明
fathered	父亲
fathers	父亲
fatigue	疲劳、使 ... 疲劳
fault	故障、指责
favor	青睐、促成
favored	青睐、受到偏爱的
favorite	最喜爱、爱好
favors	人情、恩惠
fawned	讨好、吹捧
fear	恐惧、忧心
feared	担心、害怕
fearful	可怕、吓人的
fearfully	可畏、可怕地
fearlessly	无畏无惧、毫不畏惧地
feasted	赴宴、宴请
feat	功绩、武术、手巧的
feathered	有羽毛
feathers	羽毛
feature	特点、放映
fed	喂、饲喂
feebly	有气无力、无力地
feel	感觉、触摸
feeling	感觉、富于同情心的
feelings	情怀、醑
feet	脚、尺
feets	千丈、方呎
feex	feex
feigned	假装、佯装了
fell	下跌、兽皮、残酷
fellow	同伴、朋友
fellows	研究员、侪
fellowship	奖学金、合伙
felt	毡、触
ferine	ferine
ferocious	凶猛、厉害
ferocity	恶、肆虐
ferry	渡船、摆渡
fervently	热情地、踊跃
fetching	取、妩媚
fever	发烧、烧
feverish	发烧的、激昂的
fever-pitch	发烧间距
few	少数、稀少、廖
fibre	纤维、构造
field	领域、野外
fiend	恶魔、凶手
fierce	激烈、凶暴
fiercely	激烈、凶暴地
fierceness	凶猛、猛烈
fiercer	激烈
fiercest	激烈的
fifteen	十五
fifty	五十
fifty-mile	五十英里
fiftypound	五十磅
fifty-pound	五十磅
fight	打、站
fighter	战斗机、歼击机
fighters	战士、战机
fighting	战斗、战事
fights	打架、战斗
figure	弄清楚、图形
file	文件、归档
filing	备案、存档
fill	填、弥漫
filled	满、盈满
fills	填充、罢了
final	最终、结局
finally	最后、卒
find	发现、搜寻
finding	寻找、发现物
fine	精、罚款
finely	细、细微
fingers	手指、指头
finish	完、终点
finished	妥、得
finishing	结束、精加工
fire	火、解雇
fires	火灾、大火
fire-scorched	火烧焦
firewood	柴、劈柴、荛
first	第一、首次、开始
fish	鱼、钓鱼
fished	捕捞、钓鱼
fishing	钓鱼、打捞
fish-sacks	鱼麻袋
fissures	裂隙
fit	适合、健康
fits	适合、配合
five	五
fivescore	fivescore
fix	固定、奠定
fixed	固定、既定
flag	旗、鸢尾花
flagged	标记、标示
flame	火焰、焚烧
flames	火焰、焱
flaming	熊熊、炽烈
flank	侧翼、腹部
flanks	侧翼、侧面
flap	拍打、扇
flapped	拍打、襟翼
flash	闪光、闪现
flashed	闪现、亮出
flashing	闪烁、闪动
flat	平、平面
flattened	扁平,压扁
flecked	斑点
fled	逃离,出逃
flee	逃跑,逋
fleeing	逃离,出逃
fleeting	稍纵即逝,流
flesh	肉,瓤,肌肉
flew	立马,飞到
flickered	闪烁,摇曳
flies	苍蝇,飞行
flight	飞行,溃逃
fling	一扔,甩
flint-lock	燧发枪
flirted	调情,挥动
flitted	掠过,普照
flitting	飞来飞去,飞舞
flood	洪水,泛滥,淹没
floor	地板,铺砌,最低的
flounder	比目鱼,辗转
floundered	乱作一团,挣扎
flour	面粉,白面
flower	花,盛开
flowers	花卉
flowing	流动,湝,丰满
flows	流,流入
flung	甩到,猛地
flush	红晕,旺盛,紧紧地,丰足的
fluttered	飘扬,迎风
flying	飞行,急速的
foaming	发泡,泡沫
foe	敌人,冤家
folds	褶皱,折痕
follow	遵循,跟随
followed	其次,遵循
following	以下,跟随
folly	蠢事,胡说八道
food	食物,营养品
fool	傻瓜,糊弄,愚蠢
fooled	上当,蒙蔽
fools	傻瓜,愚人
foot	脚,步行
foot-gear	鞋袜
footing	的基础,关系
footsore	脚痛,磨破
footsteps	步伐,步子
for	为,替,因为
forbear	隐忍,避免
forbiddingly	令人生畏
forbore	克制
force	强制,力量
forced	强
fore	前面,前部
forebears	祖先,先辈
forecast	预测,预兆
forego	放弃,在 ... 前
foremost	第一,前进的,向前
forest	森林,丛林
forevalued	forevalued
forever	永远,永久性
forewent	forewent
forged	伪造的,锻造
forgetfulness	健忘,忘记
forgot	忘记
forgotten	遗忘,被遗忘
forlorn	惆,悲凉
form	形式,构成
formed	形成,成立
former	前,前者
formidable	强大,可怕
forming	成型,形成的
forms	形式,表单
forth	向前,往外
fortune	运气,时运
fortunes	命运,国运
forty	四十
forty-mile	四十英里
forward	前锋,向前,促进,先头的
fought	战斗,转战
foul	犯规,肮脏,弄脏,不诚实地
found	铸造,勘查
fountain	喷泉,喷水池
fountains	喷泉,饮水机
four	四
fourteen	十四
fourth	第四
fox	狐狸,狐
frame	框架,构成
frankly	坦率地说,爽朗
frantically	疯狂,狂热
fraught	误人子弟,充满
free	免费,豁免,无偿地
freezing	冷冻
freight	货物,装满,货物的
freighted	被装载
french-canadian	法国和加拿大
frenzy	发狂,狂妄
frequently	频繁,时常
fresh	新鲜,使清新
fresher	清新,新鲜的
fresh-written	新鲜的书面
friction	摩擦
friendliness	友好,和蔼
friendly	友好,友善
friends	朋友,俦
friendship	友谊,交谊
frighten	吓唬,使骇怕
frightened	悚,竦惧
frightful	可怕,滔天
frightfully	感到可怕,心里好不
fringed	流苏,摇曳
from	从,离
front	前,对付
frost	霜,结霜
frosty	冷冰冰,霜白
frothing	起泡,泡沫
frowning	皱着眉头,眉头紧锁
froze	愣,僵住
frozen	冻结,冱
frustrated	沮丧,惘
full	满,饱满
full-grown	完全成熟,生长完全
fully	十分,截然
fund	基金,投资
fundamental	根本,基调
fungus-covered	木耳覆盖
fur	毛皮,以毛皮制作
furiously	奋力,怒冲冲
furnished	装饰,布置
furred	毛皮,毛茸茸
furry	毛茸茸
further	进一步,促进,更远的
fury	愤怒,暴怒
fuss	瞎忙,小题大作
futile	无用,赘瘤
futilely	徒劳
future	未来,前程,未来的
gain	获得,收益
gained	获得,上涨
gaining	获得,取得
galvanized	镀锌,电镀
gamblers	赌徒,赌客
gambling	赌博,牌局
game	游戏,赌钱,有胆量的
gamekeepers	猎场看守人,劲卒过河
games	游戏,比赛
gaping	目瞪口呆,张着嘴
garbs	garbs
gardener's	园丁,花匠
garments	服装,成衣
gas	气体,瓦斯
gashing	gashing
gasp	喘气,喘息
gasped	喘着气, 倒吸一口冷气
gasping	喘气,喘息
gathered	聚集,搜集
gaunt	憔悴的,累累
gave	给,给予
gayety	喜尚,笑料
gaze	凝视,目光
gee-pole	哎呀极
general	一般,将领
generation	代,一代
generations	代,几代
generous	大方,够意思,雍容大度
generously	慷慨,丰盛地
genial	和蔼的,暖
gentlemen	嘉宾,先生们
gentlenesses	温柔
gentler	温和的
genuine	真正,真诚
geological	地质,地理
get	得到,搜罗
getting	越来越,获得
ghost	鬼,幽魂
ghostly	幽灵的,朦胧的
giant	巨人,帧太长
giants	巨人,巨头们
gigantic	巨大,灏
gingerly	小心翼翼,战战兢兢
give	给,赐给,适应性
given	特定,赠予的,设
giving	给,礼物
glaciers	冰川,冰河
glad	高兴,欣
gladdened	欢喜,充满欣喜
gladness	欢喜,乐意
glamour	魅力,迷人的美
glance	浏览,一瞥
glanced	瞥了一眼,看了一眼
glazed	釉面,像玻璃的
gleaming	闪闪发光的,熠熠
gleefully	兴高采烈地,愉快地
gliding	滑翔,滑音
glimmering	若隐若现,微光
glimpses	瞥见,隐约可见
glitter	闪光,发光
gloomy	阴沉,忧郁
glorious	辉煌,锦绣
gloriously	光荣,荣耀地
gloss	掩饰,光彩
glowed	闪耀,发光
gnats	蚊蚋,飞虫
go	去,前往
goaded	唆使,刺激
god	上帝,菩萨
goes	去,进入
going	去,离去
gold	金,金制的
goldseekers	goldseekers
gone	走了,离去的
good	好,益处
good-natured	和善,和蔼可亲
good-naturedly	苦口婆心地,善意地
goods	货,物品
goose	鹅,嘘骂
gorge	峡谷,狼吞虎咽
got	得到,拿到
government	政府,内阁
grade	级,等差
grades	牌号,等级
grandsons	孙子,孙儿
grape	葡萄,葡萄弹
grappled	扭打,搏斗
grappling	拼杀,揪打
grasp	把握,意识
grass	草,荛
grasses	草,禾草
gratifying	喜人,顗
grating	光栅,摩擦声的
gravel	碎石,铺碎石
gravelled	砾石
gravely	严重,严肃
gray	灰色,灰白
great	大,宏大
greater	更大的,优越
greatly	非常,老大
greatness	广大,謷
green	绿色,绿色的,变成绿
greeting	欢迎,迎接
grew	增长,成长
grief	悲,悲感
grievance	不平,牢骚
grievously	悲伤,沉痛
grimly	严肃地,狞笑
grin	露齿而笑,微笑
grinned	咧嘴笑,露齿而笑
grinning	笑嘻嘻,狞笑
grip	握,把手
gripped	心惊肉跳,抓住
grit	砂砾,覆以砂砾
grittily	grittily
groaned	呻吟着
grooms	新郎,培训
grooves	凹槽,沟槽
grope	摸索,摸
groping	摸索,咸猪手
ground	地面,打基础,地面上的
grow	增长,栽培
growers'	种植者,栽培者
growing	成长,发展
growl	嗥叫,吠声
growled	咆哮,吼着
growling	咆哮,咕咕叫
growls	咆哮,低吼
grown	成长,长大的
grows	增长,生长
growth	发展,发达
grub	蛴螬,挖掘
grub-box	蛴螬盒
grub-staked	蛴螬放样
gruffly	粗声粗气,生硬地
grumbled	委屈地,抱怨道
grumbling	牢骚,嘵
grunted	哼了一声,咕哝着
grunting	叫声,呼噜
guard	卫,看守
guarded	守卫,把守
guardianship	监护,保护
guards	卫士,警卫
guided	导游,可控制的
guiding	主导,指导
guilty	有罪,内疚
gulped	一饮而尽,吞咽了一下
gun	枪,火炮
gust	阵风,鉴赏力
habits	习惯
had	有,拥有
hailed	欢呼,被誉为
hair	头发,毫
hairless	无毛,濯濯
hairy	毛茸茸,长毛的
half	一半,半截
half-breed	混血儿
half-coy	半忸怩作态
half-dozen	六
half-friendly	不友好
half-frozen	半冻
half-grown	未成长
half-reluctantly	勉强
half-savage	半数的野蛮
half-sobs	半个呜咽
half-started	未开始
half-stunned	半目瞪口呆
halfway	半路
half-wolves	半狼
halt	停止,止住
halted	暂停,中止
hammered	敲定,重创
hand	手,递交
handful	少数,满手
handicap	阻碍,困难
handkerchief	手帕,帕
hands	手
hang	挂,裱
hanging	挂,悬料
hankering	渴望,热衷
happened	发生
happening	事件,故
happiness	幸福,和蔼
hard	硬,严格
hardened	硬化,淬硬
harder	更难,越难
hardest	最难的,最坚硬的
hardly	几乎不,难以
hard-packed	硬包装
harked	联想起
harking	联想起
harm	伤害,坏处
harness	马具,套
harnessed	驾驭,利用
harnesses	线束,吊带
harnessing	治理,整治
harness-up	线束,马具
harrying	饶过
harsh	苛刻,刻薄
has	有,具有
haste	赶快,迮
hastened	赶紧,连忙
hatchet	斧头,短柄斧
hated	恨,短柄斧
hatred	仇,恚恨
hats	帽子,礼帽
hauled	拖拉,拽出
hauling	牵引,拖运
haunches	臀部,腰腿
haunted	闹鬼,鬼屋
have	有,含有
having	有,菲薄的
haw	山楂,唉!
he	他,男人
head	头,率领
headed	为首,率领
heading	标题,名称
heads	头,元首
head-waters	源头
healed	愈合,痊愈
health	健康,身体
heaped	堆,挤
hear	听,得悉
heard	听说,听到
hearing	听力
heart	心脏,内心
heartbreaking	悒,忧愁
heart-easy	和易
hearts	心中,心灵
heat	热,热力
heaven	天堂,苍天
heavier	更重,加重
heavily	严重,大量
heavy	重,沉重
hedged	对冲
heed	注意,留意
heels	脚跟,鞋跟
heem	谦
height	高度,身高
held	保持,召开
hell	地狱,见鬼
hells	地狱
hell's	地狱的
help	帮助,帮忙
helped	帮助,协助
helper	帮手,佣工
helpers	佣工,家务助理
helping	帮助的,有助于
helpless	无助,无奈
helplessly	无奈的,眼巴巴
helplessness	无奈,无助感
her	她的
heralded	预示,宣告
herd	群,追风
here	这里,此间
heredity	遗传
heroic	英勇,英雄
herself	她自己
he's	他的
hesitate	迟疑,犹豫
hey	哎,嘿
hi	你好
hid	躲在
hidden	隐蔽,潜在
hide	隐藏,隐瞒
hides	皮张,兽皮
hiding	藏,藏匿
hiding-place	藏身处,掩藏地方
high	高
higher	更高
highly	高度,高效
high-strung	高度紧张,酥脆
high-walled	高壁
hike	远足,徒步
hill	山,小丘
him	他
himself	他自己
hind	后
hinder	阻碍,妨碍
hint	暗示,提示
hip	臀部
hips	臀部,臀围
his	他的
history	历史
hitch	拴住,顺利
hitching	顺风车,搭上
hitting	击球,触及
ho	浩,镐
hoarse	嘶哑,苍老
hoisted	悬挂,升起
hold	持有,握住
holding	保持,持球
holds	持有,保持
hole	孔,窿
holes	孔,洞
home	家,乡土
homesick	想家
honestly	老老实实,实在
honked	按喇叭,拽住
honored	荣幸,有头有脸儿
hoofs	马蹄声,蹄子
hope	希望,祈望
hoped	希望,期望
hopeless	绝望,不可救药
horns	角,觡
horrible	可怕,吓人的
horribly	可怕
horror	恐怖,恐惧
horse	马,系马于
horse-hide	马皮
horses	马匹
hostile	敌对的,怀敌意的
hot	热,辛辣
hotel	旅馆,饭店
hour	小时,钟头
hours	小时
house	房子,家务,驻扎
house-dog	家犬
housemaids	女佣,女仆
how	如何,何以
however	但,不过,多么
howl	嗥,吼叫
howled	怒吼,嚎叫
howling	嚎叫,瑟瑟
huge	巨大,硕大无朋
hum	哼,哼声
humans	人类,人体
humor	幽默,迎合
hundred	百
hundreds	数百
hundredweight	担
hung	挂
hunger	饥饿,渴望
hunger-madness	饥饿和疯狂
hungry	饿,馁
hunted	猎杀,追杀
hunter	猎人,迹人
hunters	猎人们
hunting	狩猎,猎狐
hunting-knife	猎刀
hunts	狩猎,捕杀
hurled	投掷,忿忿
hurling	投掷,辗转
hurricane	飓风,暴风骤雨
hurried	慌忙,造次
hurriedly	匆匆,仓促
hurry	赶快,匆忙
hurt	坏处,击伤,憖
hurting	伤害,坏心肠的
husband	丈夫,撙节
husband's	丈夫的
huskies	哈士奇,爱斯基摩犬
husky	沙哑,粗
hydrophoby	疏水性
hysteria	歇斯底里
i	我
ice	冰,冰镇
idea	想法,意念
ideal	理想,完美
idle	闲置,空费
idols	偶像
if	如果,假如
ignominiously	可耻,不光彩
ignored	忽视
ill	生病,坏
i'll	我将
ill-tamed	虐待被驯服
illumined	照亮,照耀
i'm	我是
imagination	想像力,假想
imagined	想象
immediate	即时,立刻
immediately	立即,即刻
impact	碰撞,对 ... 发生影响
impartial	公正,不偏不倚
impatience	不耐烦,性急
impeachment	弹劾
impede	阻碍,阻止
impelled	推动,迫使
impending	即将
imperative	迫切,急迫
imperiously	专横,傲慢
imploringly	哀求,恳求地
important	重要,要紧
importuned	强求,纠缠
impossible	不可能,叵
impress	印,铭刻
imprisoned	监禁,在押
impulse	冲动,鼓励者
impulses	冲动,脉冲
in	在,在 ... 之内
inability	无力,无能
inarticulate	口齿不清,难以言喻
incarnate	体现
incarnation	化身,赋与肉体
inch	寸,英寸
inchan	inchan
inches	英寸,寸
incident	事件,附带的
incidentally	顺便,附随地
inclined	倾向,歪
included	包括,列入
including	包括,连
incoherent	颠三倒四,支离
incompetence	无能,不称职
incomprehensible	费解的,不知所云
inconceivably	不可思议,难以想像的
increase	提高,增强
increased	增加,上升
incurious	漠不关心
indeed	的确,果真
indefinite	不定,不明确
indeterminate	不定,无限期
indian	印度人
indians	印度人
indigestible	不消化
indiscreet	轻率,指手画脚
indiscretion	轻率,失言
indispensable	不可缺少,必需
inevitable	必然,不可避免
inevitably	必将,难免
inexorable	残酷,残暴
infinitely	无限,无穷
infinitesimal	无穷小,蝇头
inflammation	炎,燃烧
influence	影响,感染
infrequent	罕见,异样
inherited	遗传,继承
injured	负伤,翛翛
inkling	暗示,端倪
innocuously	无害
innutritious	innutritious
inoffensive	与世无争,无害
insensible	没有知觉,昏迷的
inseparable	形影不离,不可分离
inside	里面,内部
insides	内部,内侧
insidious	阴险,隐密
insist	咬定,坚持
insisted	坚持,坚称
instance	例,比方
instances	实例,情况下
instant	瞬间,即刻
instantaneous	瞬间,立
instead	代替,反而
instinct	本能,直觉
instinctively	本能,凭直觉
instincts	本能
instruction	指令,教导
insubordination	犯上,违抗命令
insular	狭隘,封闭
intelligence	情报,合理
intended	意,义务
intense	激烈,激越
intensely	强烈,厉害地
intent	意图,集中的
intention	意向,用意
intentions	意向,意向
intentness	的专心
interest	兴趣,关心
interested	有兴趣,感兴趣的
interfere	干扰,进犯
interfered	干扰,干涉
interlacing	隔行扫描,交错
internal	内部,国内
interrupt	打断,插嘴
interval	间隔,幕间休息
intervals	间隔
intimacy	亲密,亲切感
intimate	亲密,暗示,挚友
intimated	暗示,恐吓
into	进入,直到
intolerable	无法忍受,要不得
introduction	介绍,导言
introspective	内省,恍若隔世
invaded	入侵,侵略
invaders	侵略者
invested	投资
investigate	调查,追查
invitations	邀请,请柬
involuntarily	不由自主,无心地
inward	向内
irish	爱尔兰的
iron	铁,熅,坚毅的
irresistible	不可抗拒的,压倒性
irresolutely	犹豫不决
irritability	易怒,过敏性
irritable	急躁,坏心眼的
irritating	刺激性,恼人
is	是,为
island	岛,洲
issued	发行,颁布
it	它,其
it'll	它会,它将
its	其,它的
it's	这是
itself	本身,它本身
i've	我已经
jaded	厌倦的,疲惫的
jagged	锯齿状的,钩状的
jam	果酱,拥
jangling	刺耳的,不绝于耳
japanese	日本,倭
jarring	不和谐,辗轧
jaw	颚,颌
jaws	爪,颔
jealousy	妒忌,酸溜溜
jerk	挺举,性情古怪的人
jerked	猛地,挺举
jerks	抽搐,混蛋
jingling	玎,叮当作响
jingo	金革,极端爱国义
job	工作,承包
join	加入,联结
joined	加盟,合流的
joint	联合,接合,协同
jolted	颠簸,震动
journey	旅程,游历
journeyers	journeyers
joy	喜悦,欢喜
joyful	快乐,畅
joyfully	欣然,愉快地
jubilant	喜气洋洋,欢呼的
judge	法官,评判
judge's	法官
judgment	判断,意思
jugular	颈静脉,颈部的
juices	果汁,汁液
jump	跳,趯
just	只是,公正
justice	正义,欣赏
jutted	jutted
keel	龙骨,镇
keen	敏锐,尖利
keenest	最敏锐的
keenly	敏锐,踊跃
keep	保持,养活
keeping	保持,保管的
kennel-dog	犬舍的狗
kennels	狗窝
kept	保持
key	关键,锁上,基本的
keyed	键入,键控
kick	踢,踹
kidnapped	绑架
kidnapper	绑匪,拐子
kill	杀,残害
killed	被杀,断开的
killer	凶手,杀人犯
killing	谋杀,诛戮
kin	亲属,性质类似
kind	样,亲切
kind-hearted	善良,和蔼
kindliness	和蔼,恳挚
kindly	和蔼,仁慈
kindred	亲属,类似的
kinds	种,各种
king	王,国王
kittens	小猫,幼猫
knee	膝盖,膝
knees	膝盖,双膝
knelt	跪
knew	知道,认识
knife	刀,铡
knitted	针织的,编结的
knock	敲,打击
knocked	敲,撞倒
knocking	敲,敲开
knotting	打结
knotty	棘手,伤脑筋
know	知道,知悉
knowledge	知识,学问
known	众所周知,大家都知道的
knuckled	失蹄,屈服
knuckles	关节,指节
lacerated	褛,撕裂
lack	缺乏,差
laid	奠定,打下
lak	lak
lake	湖,泽
lakes	湖泊
land	土地,降落
landed	登陆,降落
landing	着陆,起货
lap	膝部,扑击
lapping	研磨,研磨
lapsed	失效,过去的
large	大,丰厚
largeness	广大,一颗宽大
larger	大,更大
largest	最大
lash	鞭挞,鞭打
lashing	绑扎,鞭挞
lashings	圈套,鞭打
last	最后,持续,剩余
late	晚,晚点
latent	潜,暗
later	后,以后,他日
latest	最新,新东西
laugh	笑,嗤笑
laughed	笑
laughing	笑,好玩的
launched	推出,发起
law	法,法则
lawgiver	立法者
lawns	草坪
lay	铺设,谎言,世俗的
lays	规定,奠定
lazily	懒洋洋地
lazy	懒,怠惰
lead	领导,领先
lead-dog	铅狗
leaden	铅制,铅灰色
leader	领导者,首领
leaders	领袖,领导
leadership	领导,督率
leading	领导,优势
leaf	叶,翻 ... 的页
lean	瘦,屈身
leap	飞跃,跳跃
leaped	跃升,跃居
leaping	高高跃起
leapings	leapings
learn	学习,记住
learned	知道,殚见洽闻
learning	学习,博学
leashed	受到约束,带牵引
least	最少
leather	皮革,抽打
leathery	似皮革的,似皮的
leave	离开,假期
leaves	叶,花瓣
leaving	离开,留下
led	领导
ledge	窗台,凸缘
leeward	背风,下风
left	离开,左边
leg	腿,路程
legion	军团,众多
legs	腿
lend	借,提供
less	少,较少
lesser	较小
lesson	教训,课时
lessoned	训诫
let	让,听任
letter	信,函件
letters	字母,书简
letting	让
level	水平,程度
levels	水平,级别
library	文库,藏书,图书馆
lick	舔,餂
licked	舔
licking	舔
lie	说谎,位于
life	生活,生机
life-and-death	生命和死亡
lifeless	死气沉沉,苍白
life's	生命的
lifetime	一生,毕生
lift	电梯,举起
lifted	解除,抬起
lifting	起重,昂
light	光,轻微,点燃
lightened	减轻,照亮
lighter	打火机,驳船
lighting	采光,明暗分布
lightish-colored	lightish-colored
lightly	轻轻,翩翩
lightning-like	闪电状
lights	灯火,浅色衣物
like	喜欢,相似,类
likely	容易,合适的
likewise	同样,憖
limb	肢,患肢
limitless	无限,漫天
limp	跛行,瘫软
limped	一拐一拐的
limping	一瘸一拐,跛行
limply	松弛的,软绵绵地
line	线,衲
linger	盘桓,萦绕
lingered	徘徊,逗留
lingering	缠绵,逗遛
lining	衬里,衬
linked	链接,联系
lionlike	狮子般的
lip	唇
lips	嘴唇
listen	听,聆
listened	听
listening	听
lit	点燃,发光的
literally	从字面上,按照字面
little	小,短时间
live	生活,重要
lived	住
lively	活泼,生气勃勃
lives	生活
living	活,在世
load	加载,负荷
loaded	加载,装入
loaf	面包,一块面
loafing	蛇王,偷懒
loath	厌恶,不愿意的
loathsome	作呕
locate	定位,摆放
locomotive	机车,火车头
locomotives	机车,火车头
lodge	小屋,寄宿
log	登录,航海日志
logs	日志,原木
lolling	懒洋洋地
lonely	寂寞,孤独
long	长,渴望
long-barrelled	长管,长筒
long-desired	长期渴望
long-drawn	旷日持久,漫长的
longer	不再,更长
long-expected	期待已久的
long-furred	长毛皮
longings	渴望
look	看,注视
looked	看着,望着
looking	寻找,廋疏
loom	织机,嶢
loose	松,放荡,放纵
loosed	松动,疏松
loosely	松弛地
loosen	松开,松土
looted	洗劫一空,劫掠
lope	诺普,大步慢跑
loped	大步,抬
lord	主,贵族
loser	失败者,输家
loss	损失,折耗
losses	损失,亏损
lost	丢失,迷
lot	很多,抽签
lottery	抽奖,彩票
louder	响亮,大声
loudly	高声
love	爱,恋爱
loved	亲人,被爱
lovingly	含情脉脉,亲切地
low	低,低落
lower	降低,放低
lowered	降低,调低
luck	运气,幸运
lugged	吃力地,凸耳
lugubriously	转向月亮，忧伤地吠着
lunge	弓步,冲刺
lurched	蹒跚,东倒西歪
lures	诱惑,引诱
luring	引诱
luringly	luringly
lurking	隐,潜藏
lust	欲望,情欲
lusty	好色,妖媚
lying	躺在,谲
machine-like	像机器的
mad	疯狂,癫狂
made	做,取得
madly	发狂地,疯狂
madness	疯狂
magnetic	磁
magnetism	磁
magnificent	华丽的,堂皇
mail	邮件,寄
mail-train	邮政列车
main	主,优势
maintaining	维护,保持
majority	多数,成年
make	使,制造
makes	使,让
making	制造,塑造
malicious	恶毒,凶狠
malignant	恶性,坏心肠的
malinger	诈病,装病
malingerer	装病,诈病者
man	男人,曼
manage	管理,处置
managed	管理,托管
mandate	要求,委任统治
mane	鬃毛,髦
mangled	错位,出错
manhood	男子气概,成年
manifested	表现,体现
manifestly	显然,明白地
mankind	人类,男性
manner	方式,气派
manoeuvre	演习,调动
manoeuvred	操纵,机动
man's	男人的
many	许多,诸
many-noted	许多瞩目的
marauders	乱兵,掠夺者
march	行军,开赴
marched	游行,行进
marching	行军,游行
marked	标,醒目的
marks	商标,标记
marvellous	奇妙,不简单
mass	块,弥撒,群众的
massive	大规模,魁伟的
master	主,精通
mastered	掌握,精通
masterful	高超,熟练的
masters	主人,高手
master's	硕士
mastership	精巧,主人身份
mastery	征服,发迹
mastodon	乳齿象
match	匹配,相配
matching	匹配,配套
mates	队友,伴侣
matted	乱蓬蓬,纠缠的
matter	问题,碍事
matters	事项,事宜
may	可能,堪
mayo	梅奥,梅欧
me	我,余
meal	餐,进餐
meal-time	吃饭的时候，
meaning	意思,意义深长的
means	手段,繇
meant	意思,旨在
meantime	与此同时,其间
measured	测量,合标准的
meat	肉,食物
mebbe	mebbe
meditated	沉思,打坐
meekly	谦和,忠厚地
meet	满足,会晤
meeting	会议,召集
mek	人民圣战者组织
melancholy	愁绪,悲哀
member	成员,构件
memorable	难忘
memories	回忆
memory	记忆
men	男人
menace	威胁,威胁者
menacing	来势汹汹,险恶
menacingly	来势汹汹,恶狠狠
mend	修补,修补处
mending	修补,修布
mentally	精神上,心理上
merciless	无情,残忍
mercilessly	无情地,狠狠地
mercy	怜悯,慈悲
mere	只,泽
merely	仅仅,只顾
merrily	欢快
mess	胡来,弄糟
message	信息,带信息
messengers	使者,信使
met	会见,满足
metal	金属, 金属制的, 以金属覆盖
metallic	金属的,含金属的
metamorphosed	变质,幻化
method	方法,条理
mewed	mewed
mexican	墨西哥的
mid	中,在 ... 之中,中央的
middle	中间,腰
middle-aged	中年
midmost	在中间
midnight	午夜,夜半
midnights	午夜,深夜
midst	中间,当中
midway	中途,半路
might	威力,强权
mightily	强烈地
mighty	威武,极
migrating	迁移,移转
mile	英里
miles	英里
mill-race	磨比赛
mind	介意,在意
mine	矿,开采,我的
miners	矿工
miners'	矿工的
mines	矿山
mineself	这么想
mining	采矿,敷设地雷
ministrations	服侍,侍奉
minor	未成年人,辅修,副修科目
minutes	分钟
miracle	奇迹,神迹
miscalculated	失算,错估
misdeed	劣迹,坏事
misdemeanors	轻罪,劣行
miserable	惨,忧伤
misery	苦难,悲楚
missed	错过,无缘
missing	失去,不见的
mistake	错误,弄错
mistaken	错,谬
misunderstandings	误解
misunderstood	误解
mite	螨
mittened	掩着
mittens	连指手套
moaned	呻吟
moccasins	硬底软面拖鞋
moch	MOCH
mode	模式,状态
moisture	湿气,澍
moment	时刻,契机
moments	时刻
moment's	片刻的
momentum	势头,冲力
money	钱,款
mongrels	杂种,唐狗
monosyllabic	单音
monotonous	单调,平板
months	个月
mood	心情,气氛
moods	情绪
moon	月亮,蟾蜍
moon-flooded	月亮充斥
moonlight	月光
moose	驼鹿,麋鹿
moose-hide	驼鹿皮
mops	拖把,股东专栏
moral	道德,合乎道德的
more	更多,弥
morning	上午,初期
morose	忧郁
mortal	凡人,会死
mosquitoes	蚊子
moss	苔,泥沼
most	最
mother	母亲,收养
mothers	母亲
mother's	母亲的
motion	运动,提案
motionless	不动,侐
mould	模,铸造
mountain	山,岳
mountainous	多山,嶡
mountains	山
mournful	悲切, 酸溜溜
mournfully	凄然 ,悲哀
mourning	丧 ,服丧
mouth	口 ,高声地说话
move	移动 ,运动
moved	移动, 搬到
movement	运动 ,机心
movements	运动 ,动作
moving	移动 ,动态
much	多, 诸
muck	粪肥 ,施肥
mud	泥 ,秽土
muddy	浑 ,泥泞的
mug	杯 ,扮鬼脸
multiplied	乘以 ,成倍
multitudinous	众多 ,洋
murmur	潺潺 ,私语
murmured	喃喃地
murmurs	杂音 ,低语
muscle	肌肉 ,筋
muscles	肌肉
muses	缪斯 ,沉吟道
mush	浓粥 ,感伤的话
mushers	mushers
mushy	糊状的 ,感伤的
music	音乐 ,籁
musing	沉思 ,冥想
must	必须 ,应当
mustache	胡子 ,髭
mustn't	不得 ,不许
mutiny	兵变 ,暴乱
muzzle	枪口 ,上口罩
my	我的
mysterious	神秘 ,莫名其妙
mysteriously	神不知鬼不觉 ,鬼使神差
mystery	神秘 ,玄虚
nagging	唠叨 ,挑剔的
naked	裸 ,明白的
name	名称 ,指名
nameless	无名 ,匿名的
names	名
narrow	窄 ,缩小
native	本地人 ,迹先
nature	性质 ,脾性
near	贴心, 薄, 近
neared	接近
nearer	接近
nearly	将近
necessaries	必需品
necessarily	一定 ,必
necessary	必要 ,日用品
neck	颈部 ,拥吻
neck-hair	颈毛
need	需要 ,要有
needed	需要
needle	针 ,猛推
needs	需求
neighboring	邻近 ,附近
neither	也不 ,二者都不
nerve	神经 ,鼓起勇气
nervous	紧张 ,忧愁
nest	巢 ,筑巢
nests	巢 ,燕窝
nevaire	nevaire
never	从来没有 ,决不
nevertheless	虽然 ,顶
new	新 ,新奇
newborn	新生 ,乳
newcomers	新人
new-fallen	新堕落
newfoundland	纽芬兰
news	新闻 ,音信
newspapers	报纸 ,报刊
next	下 ,然后 ,比邻
nice	好看 ,过份挑剔的
niggerheads	niggerheads
night	夜, 夜晚的
nightmare	梦魇 ,寎
nights	夜
night's	晚上的
nine	九
nineteen	十九
nip	扼杀 ,讽刺
nipped	消灭 ,冻坏
no	没有 ,拒绝
noblest	最高贵的
nobody	没有人
nocturnal	夜 ,夜鸟
nodded	点了点头
nodding	点头
noise	噪音 ,吵
noiselessly	无声
noises	噪音
nomadic	游牧
none	没有
nor	也不 ,也没有
north	北
northland	北国
northwest	西北 ,向西北
nose	鼻子 ,侦察出
noses	鼻子
nosing	收口
nostrils	鼻孔 ,扑鼻而来
not	不 ,无
notches	缺口 ,槽口
note	注意 ,笔记
noted	注意 ,著名的
nothing	无 ,琐事
notice	注意 ,觉察
noticing	注意到
now	现在 ,此刻 ,既然
nowhere	无处 ,无价值的东西
nudge	轻移
nuggets	掘金
numb	麻木 ,使 ... 昏迷
numerous	众多 ,成千上万
nursed	调养 ,护理
nursing	护理 ,养育的
nutriment	养料
oath	誓言 ,起誓
oaths	宣誓
obdurate	顽固 ,执拗
obedience	服从 ,百依百顺
obediently	乖乖
obey	服从 ,遵
obeyed	服从 ,顺服
obliterated	抹杀 ,冲掉
obscurely	隐晦 ,模糊
obscureness	obscureness
observed	观察到 ,遵守
obtained	获得 ,取得
occasion	场合 ,致使
occasional	偶然 ,临时的
occasions	场合
occupants	住户 ,乘员
occupied	占领 ,有事
odd	奇 ,莫名其妙
odds	可能性 ,优越性
of	的 ,于
off	离 ,隔断,右
offence	犯罪 ,过错
offending	得罪 ,违法
offensive	进攻 ,有攻击性
offer	提供 ,议案
offered	提供
offering	提供 ,奉现
office	办公室 ,机关
official	官方 ,官
often	常,频繁
oftener	更经常
oh	哦
old	老 ,往昔
older	旧
oldest	最老 ,大
old-time	过时的 ,古来的
on	上 ,在 ... 之上
once	一次 ,一旦
one	一 ,壹
one-eyed	独眼的 ,瞎
ones	的
one's	一个人的
onlookers	围观 ,旁观者
onlooking	旁观
only	只 ,只不过
onset	发病 ,猛攻
open	打开 ,开阔,空旷
opened	打开
opening	开盘 ,开幕的
openly	公然 ,摅诚
operating	操作 ,工作的
opinions	意见 ,看法
opportunity	机会 ,隙
opposing	反对 ,相反
opposite	相反 ,对立面 ,在 ... 对面
oppressed	被压迫 ,堵
or	或
orchard	果园,果树
orchards	果园
ordained	受戒 ,按立
order	秩序 ,顺序
orderly	秩序 ,勤务兵 ,利落
orders	订单 ,命令
ordinary	普通 ,等闲
organizing	组织 ,举办
original	原 ,原有
orthodox	正统 ,保守的
other	其他 ,另一样子
others	他人 ,其余
other's	其他的
ounce	盎司 ,两
our	我们的 ,敝
out	出 ,广大的,明显地,到 ... 外
outta	离开
outcome	结果 ,产物
outdistanced	凌驾
outdoor	户外 ,室外
outer	外 ,打倒
outfit	配备 ,旅行装备
outhouses	外屋
outlined	概述
outlines	概述 ,列出
outlook	展望 ,前途
outrage	愤怒 ,侮辱
outreached	外展服务
outside	外 ,外面
outsides	外侧
over	以上 ,剩余,外部的
overfeeding	过度喂食 ,超喂
overhanging	悬垂
overhauled	大修 ,检修
overhead	开销 ,在楼上
overloaded	超载
overlooked	忽视
overpowering	压倒性
overrunning	超限 ,侵占
overspilling	泻
overtake	超车,超过
overtaken	超越 ,追上
overthrow	推翻 ,打翻
overthrowing	推翻 ,颠覆
overthrown	推翻
overture	序曲 ,试探
overturning	倾覆 ,翻转
own	自己的 ,拥有,所有
owners'	业主立案法
pace	步伐 ,步行
pack	包 ,收拾
packed	满 ,嬴
packing	填料 ,填密
packs	包
paddocks	围场 ,牧场
pads	垫,焊盘
paid	支付
pain	疼痛,苦痛
painful	痛苦 ,酸痛
painfully	痛苦 ,费力地
pains	辛劳
painstakingly	精心 ,苦
pair	对 ,配对
pale	苍白 ,范围,砦
paled	苍白
pall	棺罩 ,覆盖
palmated	蹼
palpitant	发抖的
pampered	娇
pandemonium	乌烟瘴气
pangs	阵痛,痛苦
panic	恐慌 ,恐吓,惊慌的
pans	锅
panther	豹 ,美洲豹
panting	气喘吁吁 ,气短的
paradox	悖论 ,佯谬
parallel	并行 ,纬线,偩
parcels	包裹
parched	燥,炒过的
park	公园
paroxysms	发作,阵发性
part	部分,分开
part-grown	成长的部分
particle	粒子,助词
particular	特别,个别项目
particularly	尤其,独特地
partly	部分地
partners	合作伙伴
partnership	合伙,合作关系
partridges	鹧鸪
parts	部分
party	党的,当事人
pass	通过,关口
passage	通道,航程
passed	通过,过时的
passes	通过,传递
passing	通过,短暂的,非常
passion	情感,表感
passionate	多情,惛怓
passive	被动,被动式
passiveness	被动
past	过去,往,晚于
pastures	牧场,草场
patches	补丁
path	路径,走道
patience	忍耐,耐性
patted	拍拍
pause	暂停,休止符
paused	暂停
paws	爪子
pay	付,报酬
peace	和平,肃静
peaks	峰
peculiar	奇特,特有财产
peculiarity	特点,怪癖
peculiarly	特有的
peer	同行,窥视,同等的
peered	凝视
pellets	颗粒
pell-mell	乱七八糟地,杂乱的,极度紊乱
pencil	铅笔,画
penetrate	穿透,弥漫
penetrated	渗透
pent	压抑
people	人们,使住人
pepper-boxes	辣椒盒
perambulating	perambulating
perceived	感知
perceiving	感知
perceptibly	事倍功半
perches	栖息
peremptorily	一股脑
perfect	完美,完成式,醇化
performance	性能
performed	执行
perhaps	也许,恐怕
peril	冒险,岌
periods	期间
permanent	永久,常设
permitted	允许,合法的
permitting	允许
perpendicular	垂直,垂直的位置
perpetual	永久,永恒
perplexed	困惑,迷茫
persisted	坚持
persistent	一贯,固执
personal	个人,自身
pertinacity	顽固
pervaded	弥漫
pet	宠物,发脾气,亲昵的
petted	宠爱
petty	小气,零用
phrase	短语,用短语表达
physical	物理,体格检查
pick	挑,遴选
picked	挑,采摘的
picking	选择,采
piece	片,拼凑
pieces	件
pile	堆,拥挤
piled	堆积,堆着
pine	松,块垒,松的
pines	松树
pipe	管,吹笛
pipes	管道
pistol-shot	手枪杆
pitch	沥青,野营
pitched	倾斜的,沥青涂的
pivoting	枢轴
placatingly	placatingly
place	地方,放置
placed	放置
placer	砂矿,放置者
places	地方
plain	简单的,平川
plainly	分明
plaint	感叹,诉苦
plant	厂,栽种
play	玩,游玩
played	发挥
playfully	开玩笑
playing	打,游玩
plays	扮演
pleaded	承认
pleading	恳求
pleased	高兴,得意
plentee	plentee
plenty	丰富,济,非常
plethoric	过多的,过剩的
plight	困境,保证
ploughed	犁
pluck	采摘,胆量
plum	梅,直立地,梅色的
plunge	跳水,跳进
plunged	暴跌
plunging	暴跌
plus	加,附加的,正数
point	点,指出
pointed	尖
pointedly	有针对性地
pointers	指针
pointing	指着
points	点
poise	平衡,使 ... 平衡
poised	蓄势,旖旎
poked	戳
pole	极,用棒推
poled	极化
police	警察,维持治安
poling-boat	极化的船
politeness	礼貌,有礼貌
political	政治,政治犯
pompous	自大的,嘐
pooh	维尼
pool	水池,凑钱
pools	池
poor	差,贫民
poorer	较差
poplars	杨树
populous	人口稠密
porcupine	豪猪
position	位置,姿势
positive	积极,正片
possess	拥有,占有
possessed	拥有,着魔的
possession	所有权,领地
possibility	可能性,远景
possible	可能
possibly	或者,容许
potent	有力的,霸道
pouch-strings	袋字符串
pound	英镑,冲击
pounded	捣烂,捣碎
pounding	捣
pounds	英镑
pour	倒,倾泻
poured	倒
powdery	粉状,粉的
power	功率,强权
powerfully	有力,严词
practically	几乎,事实上
practised	熟练,精明
praise	赞美,表扬
prayed	祈祷
preaching	说教
precious	珍贵,非常,爱人
precipitate	沉淀,促成
preeminently	讲话
preferred	首选
pregnant	孕,大肚子
prejudices	偏见
preliminary	初步,初步行动
prepared	准备,将
preparing	准备,编制
presence	存在,光临
present	目前,介绍,当代
presenting	呈现
presently	目前,一会儿
preserver	保护者
pressed	按下,拮
pressing	压制,刻不容缓
pretty	漂亮,蛮,极好的东西
prevent	防止,免除
prevented	防止
previous	前,过急的
prey	猎物,捕食
preyed	捕食
preying	捕食
price	价格,行情
pricked	一竖
pride	自豪,使自夸
prided	引以为傲, 引以自豪
primeval	原始, 初期的
primitive	原始 , 原函数
primordial	原始 ,始基
principally	主要
prints	打印
private	私人 ,列兵
privilege	特权 ,给与 ... 特权
problem	问题 ,问题的
proceeded	进行
proceeding	进行
proceeds	所得款项 ,收益
proclaimed	宣布
proclaiming	宣讲
prodded	打了招呼 ,催促
profit	利润 ,获益
progeny	子孙 ,晜
progress	进步 ,演变
projected	预计 ,投影
prolonged	经久 ,拖延的
promise	承诺 ,约定
promises	承诺
prompt	提示 ,驱使 ,爽利
prompting	提示 ,促使
promptly	及时 ,连忙
prone	易于 ,倾向于
propelled	推动
propeller	螺旋桨 ,推进器
proper	正确 ,得当
property	财产 ,特性
proportion	比例 ,面积
proportions	比例
prosper	繁荣 ,兴盛
prospered	蓬勃发展 ,繁荣
prostrate	拜倒 ,沮丧的
protect	保护 ,捍卫
protected	保护 ,镇守
protection	保护 ,保护制度
protest	抗议 ,拒付
protested	抗议
protruded	突出 ,伸出
protruding	突出 ,凸
proud	骄傲 ,傲岸
proudly	傲然 ,昂然
proved	证明
provocation	挑衅 ,放火
prowess	实力
prowled	徘徊
pry	撬 ,窥探
ptarmigan	鹧
public	公众 ,公开
pug	泥料 ,跟踪追寻
pull	拉 ,张力
pulled	拉
pulling	拉 ,拖带
pullman	铂尔曼 ,卧车
pulse	脉冲 ,跳动
pumping	抽
punish	惩罚 ,惩戒
punished	处罚 ,惩罚
punishment	惩罚 ,刑罚
puppet	傀儡 ,木偶的
puppyhood	青年的自大时期
purposed	原定
purposely	故意 ,有意
pursued	追求
pursuit	追求 ,意兴
pushed	推
put	放 ,投击
putting	把
puzzled	困惑 ,荧
qed	QED
quality	质量 ,最高品质的
quarrel	吵架 , 拌嘴
quarrelled	争吵 ,吵架
quarrelling	争吵 ,吵架
quarry	采石场 ,挖出
quarter	季 ,驻防
quarters	住处
quaver	颤声 ,发抖
queek	queek
queen	女王 ,王后
quest	探索,寻求
quibble	狡辩 ,诡辩
quick	快,活人
quickened	加快 ,增速
quickly	很快 ,霍然
quickness	速度 ,爽利
quiet	安静 ,肃静
quietly	悄悄 ,肃静
quite	相当 ,的确
quivered	颤抖
quivering	颤颤巍巍
quoth	谈论
quoting	引用
rabbit	兔 ,野兔
race	竞赛 ,赛跑
raced	赛跑 ,比赛
races	种族
raft	筏 ,楂
rafted	筏
rage	愤怒 ,肆虐
raged	炸开了锅 ,激烈
ragged	褴褛 ,破烂
raging	熊熊 ,炽灼的
rail	轨 ,抱怨
railway	铁路
rain	雨 ,下雨
raised	凸
raisin	葡萄干
rake	耙 ,扫射
ram	公羊 ,撞击
rambles	漫步
rampant	猖獗 ,蔓生的
ramshackle	摇摇欲坠
ran	跑
rang	响了
range	范围 ,排列
ranged	不等
ranging	不等 ,归类于
rapid	快速 ,激流
rapidity	迅速
rapids	急流 ,险滩
rapped	厉声
rarely	很少 ,稀少
rashness	躁
rather	比较 ,未免
ration	配给 ,发放
rattled	叮叮当当
ravenous	饿坏了的 ,馋痨
raw	原 ,擦伤, 身上的痛处
reach	到达 ,范围
reached	达到
reaches	到达
reaching	到达
read	阅读 ,阅览 ,有学问的
reading	阅读 ,读书
ready	准备, 停当,现金
real	实 ,非常 ,真相
realities	现实
reality	现实 ,实际
realized	实现
really	真 ,果真
realm	境界 ,王国
rear	后 ,抚养
reared	饲养
rearing	饲养
rearranging	重新整理
reason	原因 ,合理
reasoned	理由
reassured	放心
rebel	反叛 ,造反者,造反的
rebels	叛军
rebound	篮板球 ,复原 ,重捆的
recalled	回忆
receding	后退
receive	接收 ,领取
received	收到 ,被认为标准的
receiving	接收 ,对
recesses	凹槽
recital	演奏会
recognize	认识 ,辨认
recognized	认可
recollections	回忆
record	记录 ,录音
recover	恢复 ,光复
recovered	恢复
recovery	复苏 ,重获
recuperated	调理
recuperation	休养
recurrent	复发
red	红色 ,朱红
red-eyed	红眼睛
red-handed	红手 ,人赃俱获
reeled	举步为艰
refreshed	刷新
refused	拒绝 ,不肯
refusing	拒绝
regained	收复
registering	注册 ,套版
regular	定期 ,合格
regularity	规律性
regularly	经常
reign	统治 ,朝
rejoin	归队 ,应答
rejoinder	反驳
relations	关系
relatively	相对 ,比较
relax	放松 ,缓和
relaxed	放松 ,轻盈
released	发布
releasing	释放 ,发布
relevant	相应  ,贴题
relief	缓解 ,地势
reluctantly	勉强 ,忍痛
remain	留 ,残留
remainder	其余 ,赢余
remained	保持
remarkable	卓越 ,不简单
remarkably	异常
remarked	说
remedy	补救 ,治疗
remember	记得 ,铭记
remembered	记得 ,想起
remnant	残余 ,遗物
remnants	残余
remonstrance	抗议 ,忠告
remotely	远程
remoter	偏远的
remotest	遥远
removed	删除 ,离开的
rend	烈 ,裂缝
rending	心碎
rent	租 ,房租,分裂
repeated	重复 ,沓
repeatedly	反复 ,不住
replaced	更换
replied	回答
replies	回复,答复
reply	回复,回答
repose	养神 ,休息
reproof	督 ,数说
repugnance	反感 ,厌恶
reputation	声誉 ,面子
required	需要 ,必要
requires	要求
rescue	营救 ,保全
rescued	获救 ,救出
resent	愤慨 ,恼恨
resented	愤慨 ,怨恨
reserve	储备 ,后备军,备用
reserved	保留的 ,含蓄
resided	居住
resiliency	弹性 ,弹力
resist	抵制 ,阻挡
resolutely	坚决 ,固
resolved	解决 ,断然的
resounding	高亢 ,轰动的
respect	尊重 ,尊敬
respectful	恭 ,夔
responded	回应 ,回答
responding	响应 ,回应
response	响应 ,应对
rest	其余 ,休憩
rested	休息 ,静置
resting	休息 ,休眠的
restlessly	躁动
restlessness	躁动 ,慌张
result	导致 ,成绩
resulting	导致 ,产生
resumed	恢复 ,继续
retained	保留
retaliate	报复 ,还击
retaliated	报复
retarded	智障 ,发展迟缓的
retarding	延缓
retraced	回抽
retreated	退守
retrogression	倒退
return	返回 ,回来
returned	返回 ,复原
returning	返回
revelation	启示 ,泄露
reverently	虔诚
revolt	起义 ,反叛
revolver	左轮手枪
revolver-shot	左轮手枪杆
rewarded	奖励 ,回报
rhythm	韵律 ,旋律
rib	肋骨 ,装肋骨
ribbons	丝带
ribs	肋骨 ,骨子
rid	摆脱,使免除
riddled	千疮百孔
ride	骑,骑马
ridiculous	可笑 ,滑稽
riding	骑术
riding-whip	马鞭
rifle	步枪 ,来福枪
rift	裂痕 ,裂缝
right	右,直接,纠正
rigorous	严格 ,严峻
rim	边 ,为 ... 之边
ring	环 ,听起来
rink	溜冰 ,滑冰场
riotously	暴动
ripe	成熟 ,发达
ripped	撕开
ripping	翻录
rippling	荡漾
rips	撕裂 ,裂口
rise	上升 ,发展
rising	攀升 ,高涨的
risk	风险 ,冒 ... 之险
risks	风险
rival	对手, 媲美,竞争的
river	河
rivers	河流
road	道路,马路
roamed	漫游
roar	吼 ,咆哮
roared	大吼
roaring	咆哮 ,咆哮的
rob	抢 ,剽
robbed	被抢
robbing	抢劫
robe	长袍 ,装饰
robes	长袍
rock	岩石 ,摇动
rocking	摇摆
rocks	岩石
rode	骑着
rolled	推出 ,轧制
rolling	滚动的 ,波荡
rolls	卷 ,卷筒
romance	浪漫 ,冒险故事
romped	轻而易举
roof	屋顶 ,盖屋顶
room	房间 ,住宿
roosted	栖
rope	绳 ,拉拢
ropes	绳索
rose	玫瑰 ,玫瑰色的
rotted	腐烂
rotten	烂 ,槁
rough	粗暴 ,蛮
roughly	大致 ,粗糙地
rounded	四舍五入
roundly	严厉 ,圆圆地
rouse	振奋 ,奋起
roused	惊醒 ,激昂
routed	路由
rove	流浪 ,漫游于
roved	忙得不亦乐乎  ,高地游弋
rows	行
royal	皇族 ,王室的
rubbed	擦 ,揉
ruction	乱子 ,复兴
rule	排除 ,裁定
ruled	排除 ,统治
run	运行 ,跑步
runners	亚军 ,选手
running	运行 ,跑的
runs	运行
rush	赶 ,灯心草
rushed	赶到 ,贸然的
rushes	七嘴八舌 ,奔涌
rushing	冲 ,旺盛的
rustled	簌簌作响
rut	发情 ,在 ... 形成车辙
ruthless	无情 ,残酷
sack	麻袋 ,解雇
sacked	落马
sacks	麻袋
sacredam	Sacredam
sacrificed	牺牲
sad	伤心 ,忧愁
safe	安全 ,保险箱,安然
safety	安全 ,安危
sagged	下垂
said	说
sakes	的缘故
salient	突出的 ,突出部
salmon	三文鱼 ,蛙鱼
saloon	轿车
saloon-keeper	轿车门将
saloon-keeper's	轿车门将的
salt	盐 ,腌,含盐的
same	同 ,同样的事物
san	圣
sang	唱了
sank	沉没 ,下沉了
santa	圣诞老人
sap	树液 ,使衰竭
sapped	大伤元气 ,削弱
sat	坐在
sated	吃饱 ,饱食
satisfaction	满意 ,满足
satisfied	满意 ,安
sausage	香肠 ,肠儿
savage	野蛮人 ,残暴
savagely	野蛮
savageness	野蛮
savagery	野蛮
savages	野人
save	节省 ,储蓄
saved	保存
savor	品尝 ,趣味
saw	锯 ,锯开
saw-logs	锯原木
saw-mill	锯木厂
say	说 ,发言权
saying	话 ,名言
says	说
scale	规模 ,延展
scaled	缩放
scales	秤
scarlet	猩红 ,赤
scarring	疤痕 ,结疤
scatter	分散 ,离散
scattered	零落 ,散漫
scattering	散射
scene	现场 ,风貌
scent	香味 ,发觉
scented	香
scenting	窨
scheme	方案 ,图谋
scholar	学者 ,读书人
schools	学校
score	得分 ,比分
scored	得分
scrambling	争先恐后 ,扰频
scraped	刮
scratched	划伤
scream	惊叫 ,呼啸
screamed	尖叫
screaming	尖叫
scruff	颈背
scum	浮渣 ,起泡沫
sea	海,  溟
search	搜索 ,寻找
searched	搜索
seasons	季节
second	第二 , 伯仲叔季,秒 , 拥护
seconded	借调
secrecy	保密 ,隐私
secret	秘密 ,分泌
secretly	偷偷 ,暗自
section	部分 ,章节
sections	部分
secure	安全 ,保险
secured	抵押
securely	牢固
see	看 ,看望
seed	种子 ,播种
seeing	看到
seek	寻求 ,查找
seeking	求
seem	似乎 ,仿佛
seemed	似乎
seeming	表面上的 ,假象
seems	似乎
seen	看到
seize	抢占 ,抢夺
seized	检
select	选择 ,挑拣
selected	选
self-appointed	自封
sensation	轰动 ,感情
sensations	感觉
sense	感觉,感到
sensed	感觉到
senseless	毫无意义的 ,糊涂的
senses	感官 ,神志
sensitive	敏感 ,识相
sent	发送
separate	分开 ,另外
separated	分离 ,睽
sequential	顺序
servants'	公务员
served	服务 ,担任
set	集 ,规定
setter	二传手
setting	设置 ,布景
settles	落户
seven	七
seventy	七十
several	几个 ,好几
severe	严重 ,严竣
severely	严重 ,严正
sex	性别 ,性交
sex-prerogative	性别特权
shade	阴 ,翳
shades	色调 ,深浅
shadow	阴影 ,盯梢
shadows	阴影
shaggy	毛茸茸 ,毵
shake	摇 ,撼
shaken	动摇 , 摇过
shaking	发抖 ,发抖的
shallow	浅 ,浅滩,粗浅
shambled	蹒跚 ,踉跄
shambling	步履蹒跚
shame	耻辱 ,抹黑
shape	塑造 ,形状
share	共享 ,股份
sharp	尖锐 ,激烈
sharply	大幅 ,截然
she	她 ,女人
shed	棚 ,散出
sheen	闪耀 ,皪,妵
sheep	羊 ,信徒
sheepishly	羞怯地 ,怯懦地
sheer	绝对 ,躲避
sheet	片 ,罩
shellfish	贝类 ,蜊
shelter	庇护 ,掩蔽
sheltered	庇护
sheltering	庇护
shep	夏普。
shepherd	牧羊人 ,领导
shifted	转移
shifting	转移
shining	发光的 ,彪炳
ship	船 ,运输
shipping	航运 ,船舶
shirked	推卸
shirks	推卸
shivered	瑟瑟发抖 ,颤栗着
shivering	发抖的
shock	震 ,休克,浓密的
shoes	鞋 ,屐
shone	闪耀着光芒，
shook	震撼,  摇摇
shoots	芽
shore	岸 ,撑持
shores	海岸 ,岸边
shoreward	向岸边
shorn	剪毛
short	短 ,简短
shorter	更短
short-haired	短发
short-legged	短腿
shortly	不久
shot	镜头
should	应该
shoulder	肩
shoulder-blade	肩胛骨
shoulders	肩膀
shouldn't	不能
shout	喊
shouted	喝道
shouting	叫喊
shove	推
show	显示
showed	显示
showing	显示
shown	所示
shreds	碎片
shrewd	精明
shrewdly	精明
shriek	尖叫
shrieked	尖叫
shrieking	尖叫
shrill	尖锐
shrouded	笼罩
shrubs	灌木
shrugged	耸了耸肩
shunned	避之唯恐不及
shutting	关闭
sick	生病
sickly	体弱多病
side	侧
sided	双面
sides	双方
sight	视力
sights	景点
sign	签署
signed	签署
signs	迹象
silence	沉默
silent	无声
silk	丝绸
silky	丝般
silly	愚蠢
silvery	银色
similar	类似
simple	简单
simply	简单地
simulated	模拟
simultaneous	同时
sin	罪
since	自
sinew	腱子
singed	烧焦
singing	歌唱
single	单
sings	唱
sing-song	卖唱
sink	下沉
sinking	下沉
sinks	汇
sir	先生
sister	妹妹
sister's	姐姐的
sit	坐
site	现场
sitting	坐在
situation	情况
six	六
sixteen	十六
sixty	六十
sixty-mile	60英里
size	大小
skeletons	骷髅
skin	皮肤
skins	皮肤
skirted	掠过
skulking	躲躲闪闪
sky	天空
skyward	天空
slack	松弛
slacked	懈怠
slake	熄灭
slammed	抨击
slanted	倾斜
slapping	打耳光
slash	削减
slashed	削减
slashing	削减
slaver	垂涎
slavered	垂涎
slaying	杀害
sled	雪橇
sledded	sledded
sled-dogs	雪橇犬
sleds	雪橇
sleek	光滑
sleep	睡觉
sleeping	睡眠
sleeping-robe	睡觉长袍
sleepy	困
slender	苗条
slept	睡
slice	片
slid	下滑
slight	轻微
slightly	略
slim	苗条
slipped	下滑
slippery	滑
slipping	滑倒
slipshod	懈
slope	坡
sloped	倾斜
slouch	伛偻
slovenly	邋
slow	慢
slower	慢
slowly	慢慢地
sluice	水闸
slyly	狡猾
small	小
smart	智能
smashed	被砸
smashing	砸
smell	气味
smelled	闻
smelling	闻
smells	气味
smiled	笑了
smiling	微笑
smothered	闷死
snags	碰壁
snake	蛇
snap	折
snapped	抢购
snapping	抢购
snaps	卡
snarl	搞乱
snarled	咆哮
snarling	狺
sneered	冷笑
sneering	嘲讽
sniffed	嗅
sniffing	嗅探
sniffs	嗅着
snort	哼
snow	雪
snowdrifts	雪堆
snowed	下雪
snowfall	降雪
snows	冬雪
snowshoe	雪鞋
snow-white	雪白
snub	冷落
snubbed	冷落
snubbing	冷落
snug	舒适
so	所以
soars	腾飞
sobbed	抽泣着
sobbing	呜咽
society	社会
soft	软
softened	软化
softer	更柔和
softly	轻轻
soft-sighing	软叹息
soil	土壤
sold	出售
soldier	士兵
solidarity	团结
solidly	扎实
soliloquized	自言自语
solitary	孤
sombre	阴沉
some	一些
somehow	不知何故
something	某物
sometimes	有时
somewhat	有些
somewhere	某处
song	歌曲
songs	歌曲
sons	儿子
soon	不久
sooner	越早
sore	疮
sorely	非常
sorrow	悲哀
sorry	遗憾
sort	分类
sorts	各种
sou	薮
sought	寻求
sound	声音
sounded	吹响
sounding	探空
soundly	香甜
sounds	声音
sour	酸
sourer	sourer
south	南
southland	南国
space	空间
spaces	空间
spacious	宽敞
spark	火花
sparks	火花
spasmodically	发作性地
spat	争吵
speak	说话
spear	矛
spears	矛
special	特别
sped	特殊教育
speech	发言
speed	速度
speedily	迅速
spent	花费
spider	蜘蛛
spik	SPIK
spilling	溢出
spinning	纺织
spirit	精神
spirit-broken	精神打破
spit	吐
spite	尽管
splash	溅
splashes	飞溅
splay	扇
splendid	辉煌
splintering	分裂
split	分裂
spluttered	啪啪
spoil	溺爱
spoiled	坏
spoke	辐
spot	现场
spouted	喷
sprang	窜出
spray	喷雾
sprayed	喷
spread	传播
spring	春天
springiness	富于弹性
springs	弹簧
springtime	春天
spruce-bough	云杉树枝
sprung	如雨后春笋般涌现
spurred	刺激
spy	间谍
squabbling	争吵
squarehead	squarehead
squarely	笔直
squatted	蹲在
squaw	斯阔
squirmed	蠕动
squirrels	松鼠
stable	稳定
stables	马厩
stage	阶段
stagger	错开
staggered	交错
staggering	踉跄
stalk	秆
stalked	大步
stamped	盖章
stand	站
standing	常设
stands	代表
standstill	停顿
star	明星
stars	星级
start	开始
started	开始
starting	开始
starts	开始
starvation	饥饿
starved	饿死
starves	饿死
starving	挨饿
state	国
stated	表示
stately	庄严
states	美国
station	站
statue	雕像
stay	留
staying	住
stead	代替
steadily	稳步
steal	偷
stealing	偷
stealthily	悄悄
steamer	汽船
steamship	轮船
steel	钢
steep	陡
steeped	浸淫
steeply	壁立
step	步骤
stepped	加强
steps	步骤
stern	凛凛
stick	粘
sticks	枝
stiff	僵硬
stiffness	刚性
still	仍
stinging	刺痛
stir	搅拌
stirred	搅动
stirring	搅拌
stirrings	蛛丝马迹
stole	偷
stomach	胃
stone	石
stood	站在
stooped	弯腰
stop	停止
stopover	停留
stoppage	堵塞
stoppages	停工
stopped	停止
stopping	停止
store	存储
stormed	冲
story	故事
stout	肥硕
stoutest	矮胖
stoutly	坚决
straight	直
strain	应变
strained	紧张
straining	紧张
strange	奇怪
strangely	奇怪
stranger	陌生人
strangers	陌生人
stranger's	陌生人的
strangle	扼杀
strangling	绞杀
strapped	拮据
straps	肩带
straw	稻草
strawberries	草莓
stray	迷路
stream	流
streamed	串流
streaming	流
streamlet	小溪
streams	流
street	街头
strength	实力
stretch	伸展
stretched	拉伸
stretches	延伸
stricken	灾区
strife	争吵
strike	罢工
striking	引人注目
strings	字符串
stringy	粘性的
stripped	剥离
strips	带
striving	努力
strokes	招
stroll	漫步
strong	强烈
stronger	更强
strongly	非常
strove	努力
struck	袭击
struggle	奋斗
struggled	挣扎
struggling	奋斗的
strung	串起
strutting	昂首阔步
studying	研究
stuff	东西
stumbled	迷迷糊糊
stuttered	结巴
style	风格
subdued	制服
submerged	湮
substitute	替代
subtle	微妙
subtler	微妙
succeed	成功
succeeded	成功
successful	成功
successfully	顺利
succession	演替
such	这样
suck	吮吸
sudden	突
suddenly	突然
suffer	受苦
suffered	遭遇
suffering	痛苦
sufficient	足够
suffocating	令人窒息的
suggested	建议
sullen	忧郁
sullenly	绷着脸
sum	总和
summer	夏天
summers	夏天
summit	首脑会议
sun	太阳
sundays	星期日
sun-dried	晒干
sun-kissed	太阳亲吻
sunland	桑兰
sunshine	阳光
superfluous	多余
superior	优越
supper	晚餐
supply	供应
suppose	假设
suppress	压制
suppressed	抑制
suppressedly	suppressedly
supremacy	霸权
supreme	最高
surcharged	征收附加费
sure	肯定
surely	一定
surface	表面
surge	浪涌
surged	飙升
surgeon	外科医生
surging	滔滔
surprise	惊
surprised	感到惊讶
surprising	奇怪
surrounded	包围
survey	调查
surveyed	受访
survive	生存
survived	幸存
surviving	幸存
survivors	幸存者
suspicious	可疑
swaggering	大摇大摆
swam	游
swarming	蜂拥
swart	黑黝黝的
swarthy	黑黝黝的
swayed	映着
swearing	誓师大会
sweater	毛线衣
sweating	大汗淋漓
sweep	扫
sweeping	广泛的
sweet	甜
sweethearts	情侣
swelled	膨胀
swelling	肿胀
swept	横扫
swift	迅速
swiftly	飞
swimmer	游泳
swimming	泳
swimming-tank	游泳坦克
swing	摆动
swinging	摆荡
swirl	漩涡
swollen	肿
swore	发誓
sworn	宣誓就职
swung	摇摆
sympathetically	同情
system	系统
tables	表
tail	尾
tails	尾巴
take	采取
taken	采取
takers	考生
taking	以
tale	故事
tale-bearing	故事息
talk	谈
talked	谈到
talking	说
tall	高大
tallow	脂
tam	担
tamed	驯服
tangible	有形
tangle	纠缠
tangled	紊
tank	坦克
target	目标
task	任务
taste	味道
tasting	品尝
taught	教
taunted	嘲弄
taut	拉紧的
teach	教
teachers	教师
teaching	教学
team	团队
team-dogs	团队狗
team-mates	队友
teams	队
tearing	撕裂
tears	眼泪
teasing	戏弄
teeth	牙齿
tell	告诉
telling	告诉
temper	脾气
temperature	温度
tempers	脾气
ten	十
tend	趋向
tenderfoot	新手
tendons	筋
tense	紧张
tent	帐篷
tents	帐篷
terms	条款
terrible	可怕
terribly	可怕
terriers	小猎犬
terrific	了不起
terrified	吓坏了
terrifying	可怕
terror	恐怖
terse	简洁的
test	测试
testimony	证词
than	比
that	该
that's	这是
thawed	解冻
thawing	解冻
the	本
theft	盗窃
their	他们的
theirs	他们的
them	他们
themselves	他们自己
then	然后
thenceforward	从此以后，
theory	理论
there	那里
thereafter	此后
therefore	因此
thermometer	温度计
these	这些
they	他们
they're	他们
thick	厚
thicket	灌木丛
thief	贼
thighs	大腿
thin	薄
thing	事
things	事情
think	认为
thinking	思维
thinks	认为
third	第三
thirst	口渴
thirsting	渴望
thirsty	渴
thirty	三十
thirty-five	35
this	这
thong	丁字裤
thorough	彻底
thoroughfare	通道
those	那些
though	虽然
thought	思想
thoughtless	粗心
thousand	千
thousands	数千
thrash	鞭打
thrashing	痛打
threading	螺纹
threatened	威胁
threatening	威胁的
threateningly	威胁
three	三
threw	扔
thrice	三次
thrill	颤抖
thrilling	惊险
throat	喉咙
throats	喉咙
throbbed	悸动
throbbing	悸动
throttled	节流
through	通过
throughout	各处
throw	扔
throwing	投掷
thrown	抛出
thrust	推力
thrusting	突刺
thumping	怦
thus	从而
tidal	潮汐
tide	潮
tides	潮汐
tide-water	水潮
tie	领带
tight	紧
tightened	收紧
tightening	紧缩
tightly	紧紧
till	直到
timber	木材
time	时间
time-card	时间卡
time-graven	时间雕刻
times	时
timid	胆小
tin	锡
tinkled	叮咚的铃声，
tips	技巧
tire	胎
tired	累
tireless	不倦
tissue	组织
tissues	组织
to	至
toes	脚趾
together	一起
toil	辛劳
toiled	劳苦功高
token	象征
tokens	令牌
told	告诉
tolerated	耐受性
toll	费
tom-fool	汤姆傻瓜
ton	吨
tone	音
tongue	舌头
tongues	舌头
tonic	补品
too	太
took	花
tools	工具
toothless	无牙
top	顶部
top-heavy	头重脚轻
topic	主题
topped	突破
tops	上衣
tore	撕
torment	折磨
tormentor	折磨
tormentors	折磨
torn	撕裂
tornado	龙卷风
tossed	扔
total	总
tote	手提包
totem-pole	图腾柱
tottered	瞧
touch	触摸
touched	感动
touches	触摸
toughest	最艰难
toward	对于
towed	拖走
town	镇
trace	追踪
traces	痕迹
track	跟踪
trade	交易
traded	交易
tradition	传统
tragedy	悲剧
tragic	悲惨
trail	线索
trails	小径
train	火车
trained	培训
trait	特点
traits	特征
tramping	流浪
trampled	践踏
transformation	转型
transformed	转化
transforming	转化
transient	短暂的
transportation	运输
trap	陷阱
traps	陷阱
travail	劳苦
travel	旅行
travelled	旅行
travellers	旅客
travelling	旅行
treacherous	奸诈
treacherously	背信弃义的
treachery	背信弃义
treasure	宝
treated	对待的
treatment	治疗
tree	树
trees	树
treetops	树梢
trembled	颤抖
trembling	发抖
tremendous	巨大
trespasser	侵入者
tribesmen	族人
trice	瞬间
trick	招
tricked	欺骗
trickle	扑簌
trickling	涓涓
tricks	招数
tried	尝试
trifle	琐事
trim	修剪
trip	旅
tripped	绊倒
triumph	胜利
triumphantly	胜利地
trot	小跑
trotted	抛出
trouble	麻烦
trouncing	痛击
trouser	裤子
truce	休战
truck	卡车
trucked	用卡车运
true	真
truly	真
trunk	树干
trunks	树干
trust	信任
try	尝试
trying	尝试
tuckered	tuckered
tuition	学费
tumbled	重挫
turn	转
turned	转身
twelve	十二
twenty	二十
twenty-five	二十五
twice	两次
twilight	黄昏
twist	捻
twisted	双绞线
twitching	抽搐
two	二
type	类型
ultimately	最终
unable	无法
unaffected	不受影响
unafraid	毫无惧色
unaided	独立的
unaltered	不变
unapproachable	难以接近
unaware	不知道
unbreakable	牢不可破
unbridled	肆无忌惮
unbroken	绵绵
unbuilt	未有建筑物
uncanny	神秘的
uncharted	未知
uncles	叔叔
uncoiled	开卷
unconcern	漫不经心
unconscious	无意识
unconsciously	不知不觉
uncontent	uncontent
uncouth	粗野
uncowed	uncowed
under	下
underbrush	草丛
underfeeding	吃不饱
underfoot	在脚下
undergrowth	发育不全
underhand	阴招
underneath	下
understand	了解
understanding	了解
understood	了解
undervalued	被低估
undesirable	不良
undid	解开
undreamed	做梦也想不到
unduly	过份
unearthed	出土
uneasily	不安
unending	无休止
unendurable	难以忍受
unexpected	意外
unfair	不公平
unfastened	解开
unfed	喂食物
unfinished	未完成
unforgetable	难忘
unheeded	无人理睬
unhesitatingly	顺口
unhitched	unhitched
universal	普及
unjust	不公
unkempt	蓬头垢面
unknown	未知
unlike	不像
unloaded	卸载
unlucky	不幸的
unmistakable	不会错的
unmolested	不受干扰
unnumbered	没有门牌
unpacked	解压缩
unpleasantly	令人不快
unpursued	冷门
unresisting	不抵抗
unrest	动荡
unrested	unrested
unruly	不羁
unseen	看不见
unsuspected	没有料到
unswerving	坚定不移
until	直到
unto	对
untold	数不清
untouched	不变
untreated	未经处理的
unusually	不寻常
unutterable	难言
unuttered	无言
unwashed	洗过
unwieldy	笨重
unwilling	不甘
unwillingly	不情愿
unwittingly	不知不觉
unwonted	少有
up	上
upon	上
uppermost	至上
upright	直立
uproar	骚动
uproariously	噱头
upstanding	正直
upward	向上
urgent	紧急
us	我们
use	使用
used	使用
usual	通常
usurp	篡夺
utensils	餐具
uttered	说出
uttering	说出
utterly	完全
vague	模糊
vaguely	依稀
vain	虚
vainly	枉然的
valley	谷
valleys	山谷
valor	勇气
vanish	消失
various	各个
varying	不同
vast	广阔
vastness	广大
vaunt	夸
veered	转向
vegetable	蔬菜
veins	纹
venom	毒液
ventured	冒险
veranda	阳台
very	很
vexation	烦恼
vibrant	充满活力
vicarious	代人受过
vicious	狠毒
victim	受害者
view	视图
views	意见
vigil	守夜
vigilant	警惕
vigils	守夜
vigor	活力
vigorously	大力
vilely	vilely
village	村
vine-clad	藤包
vines	藤蔓
violently	猛烈
virgin	处女
virility	壮阳
virtue	美德
visible	可见
vision	视力
visions	愿景
visitor	游客
vital	至关重要
vitality	活力
voice	声音
voiced	讲
voices	声音
void	无效，空虚，空间
volcanoes	火山
voracious	贪心，食欲旺盛的,渴求的
wager	赌注，以…为赌注
wages	"工资，
工钱"
wagged	摇摆，摇动
wagon	四轮运货马车， 货车 
wailing	极好的（青少年用语) 
wailings	嚎啕声 ，呼啸声
waited	等待，等待时间
waiting	等候，等待的
wake	唤醒，醒来
wakens	弱化
waking	"醒来, 醒觉，唤醒
"
walk	走, 散步 
walked	走了,步态 
wall	墙，城墙 
walls	墙壁
wan	苍白， 微弱的，暗淡的 
wandered	逛到，漫游
wandering	飘零，漫游,闲逛 
want	想要，需要
wanted	"通缉，受通缉的
"
wantonness	放荡，浪费时间，虚度光阴 
war	战争
warily	"小心翼翼地，谨小慎微地
"
warm	温暖，热情的，暖和的
war-mad	EL
warmed	回暖， 温热的
warmer	使热的人（或物）；取暖器，加温器
warmly	热烈，热情地
warning	警告，预兆
wary	警惕，谨慎
was	是
wash	洗，涡流，洗净
washed	洗，洗的
washes	"洗，洗涤物
"
washing	洗涤，待洗衣物 
washing-pan	洗涤锅
waste	浪费，失去
wasted	浪费，挥霍的；滥用的
watch	看，手表
watched	观看，监视
watchful	注意的，留心的
watching	看
water	水，给…浇水
watercourses	水道，渠道
watering	洒水,灌水,浇水
watershed	分水岭，分界线，分水界
watery	含水，水状的
wave	波，挥动，风潮
waves	波浪，挥
waving	挥舞着， 晃动
waxed	打蜡
way	方法，路
wayfarers	过路人， 步行者，徒步者
ways	方法，距离,路程
we	我们，咱们
weak	弱，疲软的
weaker	弱，懦弱的
weakly	弱，怯懦地
weakness	弱点，薄弱
wearing	穿着，穿著的,穿戴的
weary	厌倦，疲劳的
wearying	令人厌倦
weather	天气
weazened	EL
web	网
webbed	蹼，网状的，蜘蛛网状的
wedges	楔子，三角木
week	周
weeks	"威克斯（在美国，西经 91°49' 北纬 29°50'）
"
week's	本周
weeping	落泪的,哭泣的;悲哀的
weighed	权衡， 称…的重量
weight	重量
weird	怪异，古怪的 
welfare	福利，(social aid) 福利救济[英 = social security]
well	好
we'll	我们将，我们会
went	去
wept	哭泣
were	是
western	西方，西方国家
wet	湿，多雨的
we've	我们已经
whale	鲸鱼
whaling	捕鲸，惠林
what	什么，啥
whatever	任何
what's	什么是
wheedlingly	wheedlingly
wheel	轮，舵轮
wheel-dog	轮狗
wheeler	三轮车，（马车的）辕马，后马
when	何时，什么时候
whenever	每当
where	哪里，哪儿
whereat	为什么,为何【使用说明】疑问副词
wherefore	因此， 缘故,理由
wherein	其中，在那方面，在那里，在那种情况下
whereupon	于是，于是,因此,据此;随后【使用说明】关系副词
wherever	无论在哪里
whether	是否
which	哪，哪个
whichever	任何
whiff	喷气，吸入；嗅到
while	而，当…的时候，一会儿
whim	一时的兴致
whimpered	呜咽，呜咽声
whimpering	呜咽，呜咽声
whine	发牢骚，哀鸣
whined	发牢骚，哀鸣
whining	发牢骚，哀鸣
whip	鞭，鞭打，马鞭
whipped	鞭打
whipping	鞭打
whips	鞭子
whipsawed	双重损失的（因急欲补偿损失低价出售同一种证券而招致双重损失的）
whirl	回旋，旋转
whirled	回旋，旋转
whirlwind	旋风，旋风式的，急剧的
whisper	耳语，悄声说出
whispered	低声说
whistling	吹口哨;吹哨子;(似)口哨的声音
white	白
white-fanged	EL
white-hot	 白热的;热烈的,炽烈的
whiteness	清白，纯洁，无暇
whittled	喝醉酒的
whittling	削减/消耗某物
who	谁
whoa	哇，吁!叫马等停下的吆喝声
whoever	谁，无论谁
whole	整个
whom	(interrogative) 谁
whoop	叫喊，高喊，高叫
who's	谁
whose	谁的
whoso	【同义词】whoever；whosoeve
why	为什么
wide	宽
wide-eared	宽耳
wide-eyed	(因惊讶、好奇等)睁大眼睛的;惊讶的;朴素的,纯真的
wide-spreading	广泛蔓延
wielded	挥起， 行使
wife	妻子，老婆
wild	 野生的，荒芜的，
wilder	 (使)迷路;(使)迷惑
wilderness	荒野
wildfowl	野禽
wild-fowl	野生禽
wildly	疯狂，狂热地
wildness	野性， 狂暴，激烈，猛烈
wiliness	狡猾，奸诈，诡计多端
will	将，会，遗嘱
willing	愿意
willow	柳树
willows	柳树
win	赢，胜
wind	风
winded	嗦，喘气的；上气不接下气的；呼吸急促的
windows	窗口，窗户
winds	风
winking	眨眼，瞬目
winter	冬天
winters	冬天
wintry	寒冬，冬天的；冬天般的；寒冷的
wiped	歼灭，抹掉
wiping	抹，擦
wisdom	智慧，明智
wise	明智，睿智
wish	希望，愿望
wished	希望，愿望
wistfully	渴望地，渴求地
with	同，随着，陪同
withheld	拒绝提供
within	内，在…之内， 在…里面
without	无，没有
withstanding	"承受，经受住
"
witness	见证，目击
witnessed	见证，目击者
wives	妻子，老婆（复数）
woe	荣辱与共，悲哀
wolf	狼
wolf-cry	wolf-cry
wolfish	狼的；狼似的；残暴的；贪婪的
wolflike	wolflike
wolverenes	wolverenes
wolves	狼（复数）
woman	女人，妇女
womanhood	 成年女子的身份或状态 
womb	子宫
women	女性，女人，女孩，妇女（复数）
won	"
win的过去式和过去分词 ,韩元
"
wonder	怀疑，奇迹，感到奇怪
wondered	想知道
wonderful	精彩，绝妙的
wont	习惯，习俗；习以为常的事
won't	不会
wonted	通常的；惯常的；习惯性的；习以为常的
wood	木材，树林
wooded	多树木
woodpeckers	"啄木鸟，亚目
"
woods	树林
woody	木制的，木头的，像木头的
word	字，词
words	话
wore	穿（过去式）
work	工作
worked	工作
worker	工人
working	工作的
world	世界
wormed	驱虫，蠕虫病毒
worn	 wear的过去分词，用旧的
worn-out	破旧，疲惫不堪的
worried	担心
worry	担心
worrying	令人担忧
worse	更坏，更差
worshipful	崇拜，虔诚
worst	最差，最坏
worth	价值
worthily	不愧，值得地，相当地
worthless	"毫无价值的
"
wot	wot
would	将（过去式）
wouldn't	不会（过去式）
wound	伤口
wounded	负伤，受伤的
wounds	伤口
wraith	幽灵， 鬼，幻影
wrangled	争吵，吵架，争执，口角
wrap	包裹，打包
wrapped	包裹
wrappings	包装纸，绷带，包装带
wrath	愤怒，复仇，报复；惩罚
wreckage	残骸，废墟
wrenched	扭，扭伤
wrenching	痛苦， 猛扭
wrestled	摔跤，打架
wrestling	"
摔跤
"
wretched	可怜，悲惨的
wriggled	扭腰，扭动
wrinkled	起皱的，满脸皱纹的
writhed	翻腾，蠕动，蠕行
writhing	扭动着，蠕动，蠕行
written	书面的，write的过去分词 ,写
wrong	错误
wrote	写道，write的过去式
wrought	锻，精心做成的;精心制作的;装饰精美的;精致的
yard	院子
yards	院子
yawn	打哈欠
yawned	打着哈欠
yawning	打哈欠
year	年
yearning	怀念，渴望；向往，思慕；想念
yearnings	系往,热望,思慕
years	岁月
yellow	黄色
yelp	狗吠声
yelped	叫着
yelping	汪汪地叫。
yelps	狗吠
yep	没错
yet	尚，还
you	您，你
you'd	you'd
you'll	你会
young	年轻
younger	年轻的
youngster	少年，小孩
your	您的，你的
you're	你是，您是
youth	青年
you've	你有，你已经，你曾经
zeal	热情
zero	零