a	một
aback	lùi trở lại
abalone	bào ngư
abandon	bỏ đi
abandonment	sự bỏ rơi
abase	làm mất thể diện
abash	làm lúng túng
abate	làm giảm
abbe	tu viện trưởng
abbey	tu viện
abbot	tu viện trưởng (thiên chúa giáo)
abbreviate	viết tắt
abdicate	từ bỏ
abdomen	bụng
abdominal	ở bụng
abduct	bắt cóc
abed	ở trên giường
aberrant	khác thường
abet	xúi giục
abeyance	đình chỉ
abeyant	tạm nghỉ hoạt động
abhor	ghê tởm
abhorrent	ghê tởm
abide	tuân thủ
ability	khả năng
abject	hèn hạ
abjectly	một cách vô vọng
ablate	cắt bỏ
ablaze	sáng chói
able	có thể
ablution	lễ rửa tội
abnormal	bất thường
aboard	lên trên
abode	nơi ở
abolish	xóa bỏ
abolition	bãi bỏ
abominable	ghê tởm
abominate	ghét cay ghét đắng
aboriginal	bản xứ
aborigine	người bản xứ
abort	phá thai
abortion	phá thai
abound	có rất nhiều
about	về sự
above	bên trên
aboveboard	thẳng thắn, không quanh co
aboveground	trên mặt đất
abrade	làm trầy
abrasion	mài mòn
abrasive	bào mòn
abreact	giải tỏa mặc cảm
abreast	theo kịp, không lạc hậu
abridge	tước
abridgment	sự hạn chế
abroad	ở nước ngoài
abrogate	hủy bỏ
abrupt	đột ngột
abscess	áp xe
abscissa	hoành độ
absence	thiếu, không có
absent	vắng mặt
absentee	người vắng mặt
absenteeism	tình trạng thường xuyên vắng mặt
absent-minded	đãng trí
absinthe	cây ngải đắng
absolute	tuyệt đối
absolution	tha
absolve	miễn trách nhiệm
absorb	hấp thụ
absorbent	thấm nước
absorption	hấp thu
absorptive	hấp thụ
abstain	kiêng
abstention	bỏ phiếu trắng
abstinent	điều độ, kiêng khem, có chừng mức
abstract	không thực tế
abstractor	người viết bản tóm tắt
abstruse	khó hiểu
absurd	vô lý
abundance	sự phong phú
abundant	nhiều
abuse	lạm dụng
abusive	lừa đảo
abut	tiếp giáp
abysmal	khủng khiếp
abyss	vực sâu
academia	giới học viện
academic	(thuộc) học thuật
academician	viện sĩ hàn lâm
academy	học viện
acanthus	cây ô rô
accede	tán thành
accelerate	tăng tốc
accelerometer	gia tốc kế
accent	giọng
accents	giọng nói, điểm nhấn
accentual	trọng âm
accentuate	nhấn mạnh
accept	chấp nhận
acceptant	chấp nhận
accepted	chấp nhận
accepting	chấp nhận
acceptor	nguyên tử nhận ê lếch tron
access	truy cập
accessible	có thể tiếp cận
accession	lên ngôi
accessory	phụ tùng
accident	tai nạn
accidental	tình cờ
acclaim	sự ca ngợi
acclamation	sự hoanh nghênh, hoan hô nhiệt liệt
acclimate	thích nghi với môi trường
accolade	(sự) tán thưởng và công nhận thành quả
accommodate	cung cấp nơi ở
accommodated	đã cung cấp chỗ ở
accomodation	chỗ ở
accompanied	đã đi kèm
accompaniment	vật kèm theo
accompanist	người đệm (nhạc)
accompany	đi kèm, tháp tùng
accomplice	kẻ tòng phạm
accomplish	hoàn thành
accomplished	đã thực hiện
accord	hiệp định
accordant	phù hợp
according	theo
accordion	đàn ắc cooc đê ông
account	tài khoản
accountant	nhân viên kế toán
accounted	chiếm, chịu trách nhiệm
accounting	kế toán
accredit	giành được
accretion	(sự) lớn dần lên
accrual	sự dồn lại, tích lại
accrue	đổ dồn
acculturate	tiếp biến về văn hóa
accumulate	tích lũy
accumulated	đã tích lũy
accuracy	chính xác
accurate	chính xác
accusation	sự buộc tội
accuse	buộc tội
accustom	làm quen
ace	cực kì xuất sắc
acetate	chất a-xê-tát
acetone	chất a-xê-tôn
acetylene	chất a-xê-ti-len
ache	sự đau nhức
ached	đau nhức
achieve	đạt được
achieved	đã đạt được
aching	(sự) đau đớn
achromatic	không màu
acid	axit
acidic	tính a xít
acidulous	có pha a xít
acknowledge	chấp nhận
acknowledged	đã thừa nhận
acme	đỉnh cao nhất
acne	mụn trứng cá
acolyte	người hầu
acorn	hạt dẻ
acoustic	mộc
acquaint	làm quen
acquaintance	người quen
acquiesce	bằng lòng
acquire	giành được, có được
acquisition	(sự) giành được
acquisitive	có khả năng học hỏi, có khả năng tiếp thu
acquit	làm trọn
acquittal	(sự) tha tội, (sự) tha bổng
acre	mẫu (Anh)
acreage	diện tích
acrid	hăng, cay sè
acrobat	người (biểu diễn) nhào lộn
acrobatic	nhào lộn
acrobatics	đi trên dây
acronym	viết tắt
acropolis	thành phòng ngự
across	ngang qua
acrylic	a-cri-lích
act	hành động
acted	hành động
acting	đang hành động, đóng kịch
action	sự hành động
actions	hành động
activate	kích hoạt
activation	sự hoạt hóa
active	năng động
activism	chủ nghĩa tích cực
actor	nam diễn viên
actress	nữ diễn viên
acts	hành động, đóng kịch, hành vi
actual	thực tế
actuate	khởi động, phát động
acuity	tính sắc nhọn, tính sắc bén
acumen	(sự) nhạy bén, (sự) nhảy cảm
acute	cấp tính
acuteness	sự sắc xảo
ad	quảng cáo
adage	châm ngôn, ngạn ngữ
adagio	nhịp khoan thai
adamant	cứng rắn, sắt đá, cương quyết
adapt	thích ứng
adaptability	khả năng thích ứng
adaptation	(sự) thích nghi
adaptive	có khả năng thích nghi, thích ứng
add	thêm
added	đã thêm
addenda	phụ lục (số nhiều của addendum)
addendum	phục lục
addict	người nghiện
adding	thêm
addition	Ngoài ra
additional	cộng thêm, thêm vào
additive	vật để cộng vào, vật để thêm vào
addle	hỏng, thối, ung
address	địa chỉ
addressed	xưng hô; giải quyết
addressee	người nhận
adduce	viện (lý lẽ)
adenoma	u tuyến
adept	giỏi
adequacy	(sự) tương xứng, (sự) thích đáng
adequate	đủ, đầy đủ
adhere	tuân theo
adherent	có quan hệ chặt chẽ với
adhesion	dính chặt vào, bám chặt vào
adhesive	chất kết dính
adieu	chào tạm biệt
adjacent	ngay sát, gần kề
adjective	tính từ
adjoin	ở kề bên, tiếp giáp
adjourn	hoãn
adjudicate	xét xử, phân xử
adjunct	định ngữ, bổ ngữ
adjust	điều chỉnh
adjusting	đang điều chỉnh
adjustment	điều chỉnh
adjutant	sĩ quan quả lý tiểu đội
administer	quản lý
administered	đã quản lý
administering	đang quản lý
administration	sự quản lý
admiral	sỹ quan hải quân
admiration	sự ca tụng, sự hâm mộ
admire	ngưỡng mộ
admissible	có thể chấp nhận, có thể thừa nhận
admission	được nhận vào một tòa nhà, trường học
admit	thừa nhận
admittance	sự cho ai vào
admitting	tiếp nhận
admixture	hỗn hợp
admonition	lời nhắc nhở
ado	khó khăn, khó nhọc
adobe	gạch sống
adolescent	thuộc tuổi thanh niên
adopt	thông qua
adoption	sự chấp nhận, sự thông qua
adoptive	nuôi
adoration	yêu quí, trìu mến
adore	ngưỡng mộ
adorn	trang điểm, trang trí
adroit	khéo léo
adsorb	hút bám
adsorbate	chất bị hút bám
adsorption	(sự) hút bám
adsorptive	(sự) hút bám
adult	người lớn
adulterous	(thuộc) tội ngoại tình
adultery	tội ngoại tình, tội thông dâm
adulthood	tuổi trưởng thành
advance	tiến
advanced	đã tiên tiến, đưa trước
advances	(sự) tiến bộ, đưa trước
advantage	lợi thế
advantageous	có lợi
advent	(sự) đến
adventure	phiêu lưu
adventures	cuộc phiêu lưu
adventurous	mạo hiểm
adverb	trạng từ
adversary	kẻ thù
adverse	bất lợi
advertise	quảng cáo
advertised	quảng cáo
advertisement	quảng cáo
advertising	đang quảng cáo
advice	lời khuyên
advisable	thích hợp
advise	khuyên bảo
advisor	cố vấn
advisory	tư vấn
advocacy	vận động chính sách
advocate	người ủng hộ
aerial	trên trời, trên không
aerobic	thể dục nhịp điệu
aerodynamic	khí động lực
aerosol	chất phun
aerospace	ngành hàng không vũ trụ
aesthetic	thẩm mỹ
afar	xa
affable	niềm nở
affair	chuyện tình cảm
affect	ảnh hưởng đến
affected	đã bị ảnh hưởng
affection	tình cảm
affectionate	trìu mến
affidavit	bản khai có tuyên thệ
affiliate	quan hệ thân thuộc
affinity	sự lôi cuốn
affirm	xác nhận
affirmation	xác nhận
affirmative	quả quyết
affirmed	khẳng định
affix	dán
afflict	làm đau đớn
affluence	sung túc
afford	đủ khả năng
afforestation	trồng cây gây rừng
affront	lời xỉ nhục
afoot	đi bộ
aforethought	cố ý
afraid	sợ
Afro	xoăn rậm
aft	ở đuôi tàu
after	sau khi
after all	Cuối cùng
afterglow	ánh hồng ở chân trời
afterimage	dư ảnh
afterlife	kiếp sau
afternoon	buổi chiều
afterward	sau đó
again	một lần nữa
against	chống lại
age	tuổi
agenda	việc phải làm
agent	đại lý
ages	những lứa tuổi
aggravate	làm nặng thêm
aggressive	hung hăng
aggressor	kẻ xâm lược
aggrieve	làm cho buồn phiên
aghast	kinh hãi, kinh hoàng
agile	nhanh nhẹn
agility	nhanh nhẹn
agitate	lắc mạnh
agleam	lóe sáng
aglow	tỏa sáng, vui tươi
ago	trước
agonizing	đang làm đau đớn
agony	đau đớn
agree	đồng ý
agreeable	dễ chịu
agreed	chấp nhân được
agriculture	nông nghiệp
ahead	trước
aid	hỗ trợ
aide	trợ lý
ail	làm ốm đau
aim	mục đích
aimlessly	một cách vu vơ, không mục đích
aint	không phải là
ain't	không phải là
air	không khí
air force	lực lượng không quân
air pressure	áp suất không khí
airborne	ở trên không
aircraft	máy bay, tàu bay
airdrop	thả xuống
airfare	giá vé máy bay
airfield	sân bay
airflow	luồng khí, luồng gió
air-holes	lỗ thông hơi
airline	hãng hàng không
airmail	bưu phẩm gửi bằng đường hành không
airplane	máy bay
airport	sân bay
airspeed	tốc độ của máy bay
airtight	kín gió
airway	đường hô hấp
airy	thoáng khí
aisle	lối đi giữa các hàng ghế
aisles	lối đi
ajar	mở hé
akin	hơi giống, na ná
alabaster	thạch cao hoa tuyết
alarm	báo động
album	an-bom ảnh
alchemy	thuật giả kim
alcohol	cồn
alcoholic	chứa cồn
alcoholism	chứng nghiện rượu
alder	cây dương tía
ale	rượu bia
alert	cảnh báo
alertness	sự lanh lẹ
algae	tảo biển
alias	tên hiệu
alibi	chứng cứ ngoại phạm
alien	người nước ngoài
alike	giống nhau
alive	sống
all	tất cả
allay	làm bớt
allege	khẳng định
allegiant	lòng trung thành
allegoric	có tính chất ngụ ý
allergic	dị ứng
allergy	dị ứng
alleviate	làm giảm bớt
alley	hẻm
alliance	liên minh
alligator	cá sấu
allocate	phân bổ
allow	cho phép
allowance	trợ cấp
allowed	đã cho phép
allowing	đang cho phép
alloy	hợp kim
allude	ám chỉ
allure	sức quyến rũ
allusion	ám chỉ
allusive	bóng gió
ally	đồng minh
almanac	niên giám
almighty	có mọi quyền lực
almond	hạnh nhân
almost	hầu như
aloe	lô hội
aloft	cao
alone	cô đơn
along	cùng
alongside	dọc theo
aloof	xa lánh
aloud	to
alp	ngọn núi
alpenstock	gậy leo núi
already	đã
also	cũng
altar	bàn thờ
alter	thay đổi
altercate	cãi lộn
alternate	thay thế
alternative	thay thế
although	mặc dù
altitude	độ cao
alumni	cựu sinh viên nam
always	luôn luôn
amaze	làm kinh ngạc
amazingly	tuyệt vời, xuất sắc
ambassador	đại sứ
amber	hổ phách
ambiance	không khí
ambient	môi trường xung quanh
ambiguity	sự mập mờ
ambiguous	khó hiểu
ambition	sự tham vọng
ambitious	đầy tham vọng
ambivalent	có cảm xúc lẫn lộn
amble	đi dạo
ambulant	đi lại được
ambulate	đi dạo
ambulatory	đi lại
ambuscade	chổ mai phục
ambush	phục kích
amend	sửa đổi
amenities	các tiện nghi
America	Mỹ
american	thuộc về Mỹ
amicable	thân mật
amid	giữa lúc
amidst	giữa
amigo	người bạn
amity	tình hữu nghị
ammonia	amoniac
ammunition	đạn dược
amoeba	amip
among	trong số
amongst	trong số
amoral	phi luân lý
amorphous	vô định hình
amount	số lượng
amperage	cường độ dòng điện
ampere	ampe
amphibian	động vật lưỡng cư
ample	phong phú
amplifier	bộ khuếch đại
amplify	khuếch đại
amplitude	biên độ
amply	đầy đủ
amputate	cắt cụt
amulet	bùa hộ mệnh
amuse	làm vui
an	một
anal	cẩn thận, kĩ tính
analeptic	hồi sức
analgesic	giảm đau
analogue	sự tương tự
analogy	tương tự
analysis	phân tích
analyze	phân tích
anarchy	tình trạng hỗn loạn
anatomic	thuộc giải phẫu
anatomy	giải phẫu
ancestor	tổ tiên
ancestors	những tổ tiên
ancestral	thuộc về tổ tiên
ancestry	tổ tiên
anchor	mỏ neo
ancient	xưa
ancillary	bổ sung
and	và
anecdotal	có tính giai thoại
anecdote	giai thoại
anemia	thiếu máu
angel	thiên thần
anger	sự tức giận
angle	góc
angry	tức giận
anguish	nỗi đau đớn
animal	động vật
animals	động vật
animate	sinh động
animated	đã diễn nhộn nhịp
animation	hoạt hình
ankle	mắt cá chân
anniversary	lễ kỷ niệm
announce	công bố
announced	đã công bố
annoy	quấy rầy
annoyance	làm phiền
annoyed	đã khó chịu
annual	hàng năm
anode	cực dương
anomaly	sự không bình thường
another	khác
answer	trả lời
answered	đã trả lời
answering	trả lời
answers	những câu trả lời
ant	kiến
antacid	chất làm giảm độ axit trong dạ dày
antagonism	sự đối lập
antagonist	kẻ quậy phá
antagonists	những kẻ quậy phá
antarctic	thuộc Nam cực
antarctica	Nam cực
antelope	loài linh dương
anterior	trước
anthem	Bài hát ca ngợi
anther	bao phấn
anthology	tuyển tập văn thơ
anthropology	nhân chủng học
anti	chống lại
antiperspirant	chất chống toát mồ hôi
antique	đồ cổ
antiseptic	chất khử trùng
antler	sừng (hươu, nai)
antlers	gạc
anus	hậu môn
anxiety	mối lo âu
anxious	lo lắng
any	bất kỳ
anybody	bất cứ ai
anyhow	dẫu sao chăng nữa
anyone	bất cứ ai
anyplace	bất cứ nơi đâu
anything	bất cứ điều/cái gì
anyt'ing	bất cứ điều/cái gì
anyway	dẫu sao chăng nữa
apart	thành từng mảnh
apathetic	thờ ờ
apathy	sự thờ ơ
ape	khỉ không đuôi
apex	chỏm
aphasia	chứng mất ngông ngữ
aphasic	người mắc chứng mất ngôn ngữ
aphid	rệp cây
aphorism	cách ngôn
apocalypse	sự diệt vong
apologetic	thuộc sách Khải Huyền
apologize	xin lỗi
apostate	bỏ đạo, bội đạo
apostle	người lãnh đạo cuộc cải cách
appalled	kinh hoàng
apparel	y phục, quần áo
apparent	rõ ràng
apparently	rõ ràng
appeal	khẩn khoản yêu cầu
appealed	kêu gọi
appealingly	một cách hấp dẫn
appear	xuất hiện
appearance	sự xuất hiện, bề ngoài
appeared	xuất hiện
appeasable	có thể cho nguôi
appeasement	sự an ủi, nhân nhượng
appeasingly	một cách an ủi, nhân nhượng
appellant	bên kháng cáo
appellate	có quyền phúc thẩm
append	viết thêm vào
appendicitis	bệnh viêm ruột thừa
appendix	phụ lục
appetite	dục vọng, lòng ham muốn
appetites	ham muốn
applaud	hoan nghênh
applause	sự tán thưởng
apple	táo
appliance	thiết bị, dụng cụ
applicable	xứng, thích hợp
applicant	ứng viên
apply	áp dụng
appoint	bổ nhiệm
appointee	người được bổ nhiệm
appointment	bổ nhiệm
apposite	thích đáng
appraisal	thẩm định
appraise	định giá
appreciable	đáng kể
appreciate	đánh giá cao
appreciation	đánh giá cao
apprehend	bắt
apprehension	sự e sợ
apprehensions	sự - e sợ; nắm lấy, tóm lấy
apprehensively	sợ hãi
apprentice	người học việc
apprise	báo cho biết
approach	phương pháp tiếp cận
approached	đã tiếp cận
appropriate	thích hợp
approve	phê duyệt
approximate	gần đúng
approximately	khoảng
apricot	quả mơ
April	Tháng tư
apron	thềm sân khấu
aquarium	bể cá
aquatic	sống dưới nước
arc	hồ quang
archenemy	kẻ thù không đội trời chung
archery	sự bắn cung
architect	kiến trúc sư
architecture	công trình kiến trúc
archive	văn thư lưu trữ
arctic	phương bắc
arduous	gian truân
are	là
area	khu vực
arena	đấu trường, vũ trường
argue	tranh luận
argument	luận cứ
argumentation	cách lập luận
argumentative	có lý, lô gích
arid	khô khan
arise	xuất hiện
aristocracy	chế độ quý tốc
aristocrat	người quí tộc
arithmetic	số học
ark	thuyền
arm	cánh tay
armchair	ghế bành
armed	đã trang bị
armor	binh chủng thiết giáp
armpit	nách
arms	những cánh tay, vũ khí
army	quân đội
aroma	hương vị
aromatic	chất thơm
arose	phát sinh
around	xung quanh
arousal	tỉnh thức
arouse	khêu gợi
aroused	đã kích thích
arrange	sắp xếp
arranged	đã sắp xếp
arrangement	sự sắp xếp
array	mảng
arrear	tiền nợ khất lại
arrest	bắt giữ
arrested	bị bắt
arrival	sự đến
arrive	đến
arrived	đến
arrogant	kiêu căng
arrogate	nhận vơ
arrow	mũi tên
arrow-end	cuối mũi tên
arrows	mũi tên
arsenal	kho chứa vũ khí đạn dược
art	nghệ thuật
arterial	(thuộc) động mạch
artery	động mạch
arthritis	chứng viêm khớp
article	Bài viết
articles	bài viết
articulate	rõ ràng
articulatory	cách phát âm rõ ràng
artifact	đồ nhân tạo
artificial	nhân tạo
artist	nghệ sĩ
artistic	nghệ thuật
artistry	tài năng của nghệ sĩ
as	như
as it is	thành ra
ascend	trèo lên
ascendant	ưu thế
ascended	đã lên cấp
ascent	trèo lên
aseptic	tiệt trùng
ash	tro
ashamed	đã xấu hổ
ashore	trên bờ
ashtray	cái gạt tàn
Asia	Châu Á
aside	sang một bên
ask	xin
asked	đã hỏi
asleep	ngủ
aspect	khía cạnh
aspirate	âm bật hơi
aspire	khao khát
aspired	đã ước nguyện
assailant	người tấn công
assailants	những kẻ tấn công
assailed	đã tấn công
assassination	ám sát
assault	tấn công
assemble	tập hợp lại
assert	xác nhận
asset	tài sản
assign	phân công
assist	hỗ trợ
assistant	trợ lý
associate	sự phụ thuộc
association	hiệp hội
assort	làm cho phù hợp
assortment	loại
assume	đảm đương
assumption	giả định
assurance	bảo hiểm
assure	cam đoan
asthma	bệnh suyễn
astonish	làm ngạc nhiên
astonished	đã ngạc nhiên
astonishment	sự kinh ngạc
astringent	làm se
astronaut	phi hành gia
astronomy	thiên văn học
asunder	xa ra, rời ra
asylum	nơi an toàn
asymmetry	tính không đối xứng
at	vào khi, nơi
at most	tối đa
ate	đã ăn
atheist	người theo thuyết vô thần
athlete	vận động viên
athletic	thể thao
Atlantic	Đại Tây Dương
atlas	át lát
atmosphere	bầu không khí
atom	nguyên tử
atomic	(thuộc) nguyên tử
atone	chuộc (lỗi)
atop	đỉnh, chóp
atrophic	teo
atrophy	sự teo
attach	đính kèm
attached	đính kèm
attack	tấn công
attacked	đã tấn công
attacking	đang tấn công
attain	đạt được
attempt	nỗ lực, thử
attempted	đã cố gắng
attempting	đang cố gắng
attend	tham dự
attendant	người phục vụ
attended	tham dự
attention	chú ý
attest	làm chứng
attic	gác mái
attire	quần áo
attitude	thái độ
attorney	luật sư
attract	thu hút
attracted	đã thu hút
attribute	thuộc tính
attribution	thẩm quyền
auburn	màu nâu vàng (tóc)
auction	đấu giá
auctioneer	người điều khiển cuộc bán đấu giá
audacious	táo bạo
audacity	(sự) táo bạo
audible	nghe rõ
audience	khán giả
audio	sự ghi âm
audit	kiểm toán
audition	(sự) thử giọng
auditorium	thính phòng
auditory	thính giác
augment	làm tăng thêm
August	Tháng Tám
aunt	cô, dì, thím, mợ, bác gái
aurora	rạng đông, cực quang
author	tác giả
authority	thẩm quyền
autism	bệnh tự kỷ
autobiography	tự truyện
autocracy	chế độ chuyên quyền
autocrat	người chuyên quyền
autograph	chữ ký của một người
automatic	tự động
automatically	tự động
automobile	xe ô tô
autopsy	cuộc khám nghiệm tử thi
autumn	mùa thu
auxiliary	phụ
avail	có lợi cho
avalanche	tuyết lở
avenge	trả thù
avenue	con đường có trồng cây hai bên
average	trung bình
averaged	đã trung bình
averred	xác nhận; khẳng định, quả quyết
aversive	đáng ghét
avert	tránh
avoid	tránh
avoided	đã tránh
awake	thức
awakening	thức tỉnh
awakenings	thức giấc
award	giải thưởng
aware	biết
away	xa
awe	kinh sợ
awed	kinh ngạc
awesome	làm khiếp sợ
awful	khủng khiếp
awkward	vụng về
awl	cái dùi
awoke	thức dậy
a-wonderin'	thắc mắc
ax	rìu
axe	búa
axe-handle	cán rìu
axis	trục
axle	trục xe
babble	tiếng lảm nhảm
babel	mớ hỗn độn những tiếng nói khác nhau; toà nhà cao; kế hoạch ảo tưởng;
baby	em bé
bachelor	dành cho người độc thân
back	lưng
backbone	xương sống
backdrop	sự sắp đặt
backed	đã hỗ trợ, đã thụt lùi
background	bối cảnh
backlash	phản ứng mạnh
backpack	ba lô đeo vai
backs	lưng
backstage	ở hậu trường
backup	sự hỗ trợ
backward	lạc hậu
backyard	vườn sau
bacon	thịt ba rọi
bacteria	vi khuẩn
bad	xấu
badly	một cách xấu
baffle	làm bối rối
bag	túi, cặp
baggage	hành lý
bags	túi
bail	tại ngoại
bailiff	chấp hành viên ở tòa án
bait	mồi
bake	nướng bằng lò
bakery	lò nướng
balance	cân bằng
balcony	ban công
bald	hói
bale	bó
baleen	phiến sừng ở hàm (cá voi)
ball	banh
balloon	bóng bay
ballot	lá phiếu
ballroom	phòng khiêu vũ
balm	dầu thoa
bamboo	cây tre
ban	cấm
banal	sáo rỗng
banana	quả chuối
band	ban nhạc
bandage	băng
bandit	tên cướp
bandy	tán dóc
bane	bả
bang	hạ
bangle	vòng
banish	trục xuất
banister	lan can
banjo	đàn băng giô
bank	ngân hàng
banked	đặt lòng tin
bankrupt	người phá sản
bankruptcy	sự phá sản
banquet	tiệc
banshee	yêu tinh
banter	lời bình luận
baptism	lễ rửa tội
baptistery	nơi rửa tôi
bar	thỏi
barb	ngạnh
barbarian	người man rợ
barbaric	man rợ
barbarous	chưa khai hóa
barbell	tạ
barber	thợ cắt tóc
barbiturate	thuốc ngủ
bard	nhà thơ
bare	trần, trần truồng
barefaced	trơ tráo
barefoot	chân không
barely	hầu như không
barfly	người hay la cà quán rượu
bargain	mặc cả
barge	xô đẩy
baritone	giọng nam trung
barium	ba-ri
bark	vỏ cây
barked	đã sủa
barkeep	chiêu đãi viên quầy rượu
barking	hay sủa
barley	lúa mạch
barn	nhà để xe
barnacle	hàu
barnyard	thô thiển
barometer	phong vũ biểu
baron	ông trùm
baroness	nữ nam tước
baronial	nam tuwocs
barrack	doanh trại
barracks	những doanh trại
barrage	chuỗi
barred	bị cấm
barrel	thùng tròn
barren	vô ích
barricade	chướng ngại vật
barrier	rào cản
barrow	xe đẩy
bars	những cái song chắn
bartender	người phục vụ quầy rượu
barter	trao đổi hàng hóa
basal	căn bản
base	căn cứ
baseball	bóng chày
baseband	tần số phát sóng
baseline	đường ranh giới
baseman	(bóng chày) người chặn bóng đứng gần gôn
baseplate	đế giầy
bash	đập mạnh
bashaw	người kiêu căng
bashful	bẽn lẽn
basic	cơ bản
basil	cây húng quế
basin	lưu vực
basis	nền tảng
basket	giỏ
basketball	bóng rổ
bass	giọng nam trầm
bassinet	nôi mây giành cho em bé
bastard	lai tạp, nguồn gốc thấp hèn
batch	khối
batches	lô
bate	bớt, giảm bớt
bath	tắm
bathe	tắm
bathed	tắm
bathroom	phòng tắm
baton	gậy chỉ huy
batter	bột
battered	đánh đập; bầm dập
battering	đánh đập; bầm dập
battery	pin
battle	trận chiến
battlefield	chiến trường
battlefront	tiền tuyến
battles	những trận đánh
battle-scarred	đã đầy chiến sẹo
bawd	gái điếm
bawdy	chuộc (lỗi)
bawl	nói oang oang
bayonet	lưỡi lê
be	được
beach	bãi biển
beaches	bãi biển
beachhead	căn cứ do quân đổ bộ trên bãi biển
beacon	máy phát tín hiệu dẫ đường
bead	hạt
beady	tròn, nhỏ và sáng
beak	mỏ
beam	chùm
bean	đậu
bear	đẻ
beard	râu
beardless	không râu
bearing	đang mang
beast	con thú
beasts	những con thú
beat	đánh bại
beaten	bị đánh đập
beating	đánh
beautiful	đẹp
beauty	vẻ đẹp
beaver	hải ly
became	đã trở thành
because	vì
beckon	ra dấu/hiệu
become	trở thành
becomes	trở thành
becoming	đang trở thành
bed	đã giường
bedbug	rệp
bedfast	liệt giường
bedlam	nhà thương
bedpost	cột giường
bed-rock	nền đá
bedroom	phòng ngủ
beds	những giường
bedside	cạnh giường
bedspread	khăn trải giường
bedtime	giờ đi ngủ
bee	con ong
beef	thịt bò
beehive	tổ ong
been	được
beer	bia
beetle	bọ cánh cứng
before	trước khi
beforehand	trước
befoul	làm bẩn
befuddle	làm ngớ ngẩn
beg	van xin
began	đã bắt đầu
beggar	ăn mày
begged	xin
begin	bắt đầu
beginner	người mới bắt đầu
beginning	bắt đầu
beginnings	những khởi đầu
behalf	in your behalf
behave	cư xử
behavior	hành vi
behind	sau
behold	nhìn thấy
beige	màu be
being	đang là, sự hiện hữu
belch	tiếng ợ
belie	nói ngược lại, làm trái lai; chứng tỏ là sai
belief	niềm tin
believe	tin
believed	tin
believing	đang tin
bell	chuông
belligerent	tham chiến
bells	những chuông
belly	bụng
bellying	phồng ra
belong	thuộc
belonged	thuộc
belongings	đồ đạc thuộc
belongs	thuộc
belove	yêu quý
beloved	yêu quý
below	dưới đây
belt	dây lưng
bench	ghế dài
benchmark	điểm mốc
bend	uốn cong
bending	uốn
bends	uốn cong
beneath	bên dưới
benediction	kinh tạ ơn
benefactor	người làm việc thiện
beneficent	hay làm việc thiện
beneficial	có lợi
beneficiary	người hưởng lợi
benefit	lợi ích
bent	đã cong
berate	mắng mỏ
berry	một loại dâu
berth	giường tàu
beset	bao vây
beside	bên cạnh
besides	ngoài
bespeak	chứng tỏ, tỏ ra; cho biết
best	tốt nhất, nhất
bestow	ban cho
bet	đặt cược
betray	phản bội
betrayed	đã phản bội
betrothal	lời hứa hôn
better	hơn
between	giữa
beware	hãy cẩn thận
bewildered	hoang mang, ngơ ngác
bewitch	làm say đắm
beyond	ngoài
bias	độ nghiêng
bib	cái yếm
bible	Kinh Thánh
bibliography	thư mục
bicker	cãi nhau
bickered	đã cãi nhau
bickering	đang cãi nhau
bicycle	xe đạp
bid	thầu
bide	đợi
bifocal	hai tròng
big	to, lớn
bile	mật
bilinear	song tuyến tính
bilingual	song ngữ
bilk	quịt
bill	hóa đơn
billboard	bảng xếp hạng
billiard	bi-a
billion	tỷ
billow	cuồn cuộn
bin	thùng tròn
binary	nhị phân
bind	ràng buộc
bindery	hiệu đóng sách
bing	bãi thải
binge	ăn vô độ
binocular	ống nhòm
biography	tiểu sử
biology	sinh học
biopsy	sinh thiết
birch	cây bulô
bird	chim
birds	chim
birth	sinh
birthday	ngày sinh nhật
bisect	chia đôi
bishop	giám mục
bison	bò rừng bizon
bit	chút, đã cắn
bite	cắn
bites	cắn
biting	làm - buốt, nhức nhối; chua cay, đay nghiến
bitten	cắn
bitter	cay đắng
bitterness	sự cay đắng
bi-weekly	hai tuần 1 lần
black	màu đen
blackboard	bảng đen
blacken	làm đen
black-faced	mặt đen
blackmail	hăm dọa
blackout	cúp điện
blacksmith	người thợ rèn
bladder	bàng quang
blade	lưỡi (dao,kiếm)
blame	đổ lỗi
blanch	chần
bland	ôn tồn
blank	trống
blanked	trống không
blanket	chăn
blankets	chăn
blast	luồng khói
blatant	hiển nhiên
blaze	ngọn lửa
blazed	thắp sáng rực rỡ
blazing	đang xẹt cháy, lao vút
bleach	thuốc tẩy
bleak	ảm đạm
bleary	lờ mờ
bleed	chảy máu
bleeding	đang chảy máu
blemish	tật
blend	pha trộn
bless	ban phước
blew	đã thổi
blind	đui
blinded	mù
blindfold	bịt mắt
blinding	đang đui, loà mắt
blink	ánh sáng lung linh
blinking	đang nhấp nháy
blister	chỗ rộp da
blizzard	trận bão tuyết
blizzards	trận bão tuyết
bloat	trương lên
block	khối
blockade	chặn
blockage	trục trặc
blocked	bị chặn
blocking	ngăn chặn
blond	vàng hoe
blood	máu
bloodhound	chó săn
blood-longing	giòng máu khao khát
blood-shot	đầy tia máu
bloody	đẫm máu
bloom	nở hoa
bloop	âm thanh bí ẩn dưới đại dương
blossom	trổ hoa
blot	vết
blouse	áo choàng
blow	thổi
blowfish	cá nóc
blowing	đang thổi
blows	thổi
blubber	béo
blue	màu xanh
bluebird	chim sơn ca
blueprint	bản kế hoạch, thiết kế
bluff	dốc đứng
blundered	đã sai lầm
blunderer	kẻ mắc lỗi
blundering	dại khờ
blunt	lỗ mãng
blur	sự mờ
blurry	mờ
blurt	thốt ra
blush	xấu hổ
bluster	lời khoe khoang khoác lác
boar	lợn lòi đực
board	bảng
boast	khoe khoang
boastful	sự khoe khoan
boat	thuyền
boats	những thuyền
bobbin	suốt
bodies	những thân xác
bodily	cơ thể
body	cơ thể
body guard	đội bảo vệ
bodyguard	vệ sĩ
boggy	lầy lội
bogus	giả mạo
boil	đun sôi
bold	đậm
boldest	táo bạo nhất
boldly	mạnh dạn
bologna	xúc xích thịt nghiền hun khói
bolt	bu-lông
bolted	đã bắt vít
bomb	bom
bombarded	đã bắn phá
bond	xây ghép
bone	xương
bones	những cái xương
bonfire	lửa mừng
bony	xương xẩu, còm
book	cuốn sách
bookcase	tủ sách
bookstore	hiệu sách
boom	bùng nổ
boomed	đã bùng phát
boomerang	bumơrang
booming	đang bùng phát
boorish	thô lỗ
boost	đẩy mạnh
bootleg	sao chép trộm
boots	bốt
booze	say sưa
border	biên giới
bore	khoang dùi, làm chán
borealis	thuộc gió/miền Bắc
bored	đã chán
boredom	nỗi buồn
born	sinh
borne	chịu, chịu đựng, mang, cầm,
borough	khu
borrow	vay
bosom	vòng tay
boss	ông chủ
botanic	thuộc thực vật
botanist	nhà thực vật học
botany	thực vật học
botch	làm sai
both	cả hai
bother	làm phiền
bothersome	gây khó chịu
bottle	chai
bottom	dưới cùng, đáy
bottom's	dưới cùng của
boughs	những cành cây
bought	mua
boulder	đá cuội
boulevard	đại lộ
bounce	nhảy vụt ra
bouncy	hoạt bát
bound	ràng buộc
boundary	ranh giới
bounded	đã hướng về
boundless	vô hạn
bounty	tiền trợ cấp
bouquet	bó hoa
boutique	cửa hiệu
bovine	thuộc về bò
bow	cây cung
bowel	ruột
bowl	cái bát
box	hộp
boxes	hộp
boxing	quyền anh
boy	con trai
boyish	trẻ con
boys	những con trai
brace	thanh giằng
braced	đã chuẩn bị, giữ chắc
bracelet	vòng đeo tay
bracket	dấu ngoặc đơn
brag	khoe khoang
bragged	khoác lác
braid	bện
brain	não
brainwash	tẩy não
brake	cái phanh
branch	chi nhánh
branching	nhánh
brand	thương hiệu
brass	thau
brave	dũng cảm
bravely	một cách can đảm
bravery	tánh can đảm
bravest	dũng cảm nhất
brawl	cãi lộn
brazen	trơ trẽn
breach	vi phạm
bread	bánh mì
break	phá vỡ, làm gãy
breakable	đập bể được
breakage	chọc thủng
breakdown	sự rạn nứt
breakfast	bữa ăn sáng
breaking	đang phá vỡ, làm gãy
breaks	phá vỡ, làm gãy
break-up	chia tay, phá vỡ, làm gãy
breast	vú
breast-band	giây ràng ức
breast-bands	giây ràng ức
breath	hơi thở
breathe	thở
breathed	đã thở
breathing	thở
breathless	hết hơi
breaths	những hơi thở
breathtaking	hùng vĩ
bred	nuôi, giống, loài
breed	loài giống
breeze	gió nhẹ
breezes	gió
brew	ủ
brewery	nhà máy bia
brewing	nấu chậm
bribe	đút lót
bribery	hối lộ
brick	gạch
bridal	thuộc đám cưới
bride	cô dâu
bridegroom	chú rể
bridesmaid	phù dâu
bridge	cầu
bridges	những cái cầu
brief	ngắn gọn
briefcase	cặp tài liệu
brigade	lữ đoàn
brigadier	đại tá
bright	tươi sáng
brighten	làm sáng
brilliant	rực rỡ
brindle	nâu đốm
brine	nước mặn
bring	mang lại
bringing	đưa
brink	bờ vực
brisk	nhanh
bristle	sợi cứng
bristled	đã vươn nanh dựng lông
bristling	đang tua tủa, vươn nanh dựng lông
broach	khoan
broad	rộng
broad-breasted	ngực rộng
broadcast	phát thanh
broaden	mở rộng
broader	rộng hơn
brochure	tờ rơi quảng cáo
broil	nướng
broke	đã phá vỡ
broken	bị phá vỡ
broken-heartedly	vỡ lòng
broker	môi giới
brokerage	môi giới
bronchial	phế quản
bronchitis	viêm phế quản
bronze	màu đồng
brood	ấp
brooded	đã nghiền ngẫm ủ ê
brooding	nghiền ngẫm
brook	suối
broom	chổi
brooms	chổi
broomstick	cán chổi
broth	canh
brothel	nhà chứa
brother	anh em
brother in law	anh rể (em rể)
brotherhood	tình anh em
brother-in-law	anh em rể
brothers	những anh em
brought	mang lại
brown	nâu
browse	duyệt
bruise	vết thâm
bruised	bầm tím
bruises	vết bầm tím
brush	chải
brutal	hung dư
brutality	tánh hung hăng
brutes	brutes
bubble	bong bóng
bubbled	đã bọt khí
bubbling	sủi bọt, nhộn nhịp
buck	hươu đực
bucked	đã đá ra
bucket	thùng
buckle	khóa
buckled	đã oằn
buckles	(những) khóa
bud	chồi
buddy	bạn thân
budge	nhường
budget	ngân sách
buds	nụ
buffet	tiệc đứng
bug	con rệp
bugging	nghe trộm
bugle	thổi tù và
build	xây dựng
building	đang xây dựng
built	xây dựng
bulb	bóng đèn
bulge	ưu thế
bulging	lồi lên
bulk	số lượng lớn
bulked	khối lớn
bull	bò đực
bullet	đạn (súng trường, súng lục)
bulls	con bò đực
bull's	của bò
bully	bắt nạt
bum	mông
bumble	nói lúng búng
bumblebee	ong nghệ
bump	va mạnh
bunch	bó
bunched	chụm
bundle	bó
bundled	đã đi kèm
bundles	bó
bunny	con thỏ
burden	gánh nặng
burdensome	nặng nề
burdock	cây ngưu bàng
bureau	cục
burglar	người ăn trộm
burglary	tội ăn trộm
burial	chôn cất
buried	đã chôn
burn	đốt cháy
burned	cháy
burning	đốt
burrow	đào
burrrow	tra cứu
burst	nổ
bursting	bùng nổ, vỡ ra
bury	chôn
bus	xe buýt
bush	bụi râm
business	kinh doanh, công việc
businesslike	phong cách làm thương mại
bust	ngực
busy	bận rộn
but	nhưng
butch	ái nam
butcher	người bán thịt
butcher shop	quầy bán thịt
butchery	lò mổ
butler	người hầu
butt	mông
butter	bơ
butterfly	bướm
buttock	mông
button	nút
buy	mua
by	qua
by the way	nhân đây
bye	tạm biệt
cab	xe taxi
cabbage	bắp cải
cabin	cabin
cabinet	nội các
cable	dây cáp
cactus	cây xương rồng
cadaver	tử thi
cadaverous	tái nhợt
caddy	hộp trà
cadences	những nhịp, điệu
cadent	có nhịp điệu
cadet	người đang học nghề
cafeteria	căng tin
cage	lồng
cajole	nịnh hót, đùa giỡn
calamity	thiên tai
calcium	canxi
calculate	tính toán
calculated	đã tính
calculating	đang tính
calculus	sỏi thận
calendar	lịch
calf	con bê
call	cuộc gọi
called	đã (bị) gọi, đã được gọi là
calligraphy	thuật viết chữ đẹp
calling	gọi
callous	da tay bị chay
callowness	non nớt, thiếu kinh nghiệm
callus	cục chai
calm	bình tĩnh
calmly	một cách bình tĩnh
calves	con bê; bắp chân
came	đến
camel	lạc đà
cameo	đồ gốm mài
camera	máy chụp ảnh
cameraman	thợ chụp ảnh
camouflage	ngụy trang
camp	trại
campaign	chiến dịch
camped	đã cắm trại
camping	đang cắm trại
camps	trại
campus	khuôn viên trường học
can	có thể
canadian	canadian
canal	kênh
canary	chim hoàng yến
cancel	hủy bỏ
cancellation	hủy bỏ
cancer	ung thư
candid	thẳng thắn
candidacy	ứng cử
candidate	ứng cử viên
candle	nến
candlelight	ánh nến
candlestick	giá đỡ nến
candy	kẹo
cane	mía
canine	(thuộc) chó
canister	bình
canned	đóng hộp
cannery	nhà máy đồ hộp
cannon	súng đại bác
cannonball	đại súng thần công
cannot	không thể
canopy	vòm
can't	(cannot) không thể
canvas	vải
canyon	hẻm núi
cap	nắp, nón
capable	có khả năng
capacious	có dung tích lớn
capacity	công suất
cape	mũi đất
caper	tội phạm
capillary	mao mạch
capital	thủ đô
capitulate	đầu hàng
caprice	bất ngờ
capricious	thất thường
capsized	đã lật úp
captain	đội trưởng
captivate	làm say đắm
captive	bị bắt giữ
captor	kẻ bắt giữ
capture	bắt giữ
car	xe hơi, ô tô
carbohydrate	Carbohydrat
carbon	các bon
carcass	tử thi, thây
carcasses	xác, thây
card	thẻ
cardiac	thuộc về tim
cardiology	tim mạch học
cardiovascular	tim mạch
care	quan tâm
cared	đã quan tâm
career	sự nghiệp
carefree	vô tư
careful	cẩn thận
carefully	một cách cẩn thận
careless	bất cẩn
caress	vuốt ve
caressing	vuốt ve
caretaker	quản gia
cargo	hàng hóa
carnival	ngày hội
carnivore	cây ăn sâu bọ
carnivorous	thú vật ăn thịt sống
carol	bài hát mừng
carp	cá chép
carpenter	người thợ mộc
carried	đã mang , đem
carrot	cà rốt
carry	mang
carrying	đang thực
cart	giỏ xe
cartilage	sụn
cartoon	phim hoạt hình
cartridges	hộp (mực, đạn...)
carve	tạc
carven	thuyền buồm nhỏ
case	trường hợp
casebook	sổ ghi những công việc đã giải quyết
cash	tiền mặt
cashier	thu ngân
casino	sòng bài
cask	thùng
casket	quan tài
cassette	băng catxet
cast	ném
casual	bất chợt
casualty	người bị thương
cat	con mèo
catalysis	sự xúc tác
catalyst	chất xúc tác
cataract	bệnh đục thủy tinh thể
catastrophe	tai ương
catastrophic	thảm khốc
catch	bắt
catching	bắt
catchy	dễ nhớ
category	hạng mục
caterpillar	máy kéo xích
catfish	cá da trơn
cat-footed	như chân mèo
catharsis	phấn chấn
cathedral	nhà thờ lớn
catholic	đạo thiên chúa
Catholicism	đạo thiên chúa
catlike	như mèo
cattle	gia súc
cattleman	người chăn trâu bò
cattlemen	tay chăn bò
caught	đã (bị) bắt
caulk	hàn
cause	nguyên nhân
caused	đã (bị) gây ra
caution	sự thận trọng
cautious	thận trọng
cautiously	thận trọng
cavalier	ung dung
cavalry	kỵ binh
cave	hang động
cave-dweller	kẻ sống ở hang động
cavern	hang lớn
cease	nghỉ, ngừng
ceased	đã ngừng
ceiling	trần nhà
celebrate	kỷ niệm, làm lễ kỉ niệm
celebrity	người nổi tiếng
celerity	sự mau chóng
celestial	(thuộc) trời
cell	phòng tù
cell phone	điện thoại di động
celler	hầm chứa
cellular	có lỗ
Celsius	độ C
cement	xi măng
cemetery	nghĩa trang
censor	kiểm duyệt
census	sự kiểm kê
centenary	lễ kỉ niệm một trăm năm
centennial	(thuộc) lễ kỉ niệm một trăm năm
centerpiece	chính giữa
centipede	con rết
central	trung tâm
centre	trung tâm
centring	đi tới, đánh dấu
centuries	những thế kỷ
century	thế kỉ
ceramic	(thuộc) nghề làm đồ gốm
ceremonial	nghi thức
ceremony	lễ
certain	nhất định
certainly	chắc chắn
certainty	điều chắc chắn
certificate	giấy chứng nhận
certify	xác nhận
certitude	sự tin chắc
cessation	chấm dứt
chaff	chuyện không quan trọng; từ chối
chaffering	trả giá, kỳ nèo
chain	chuỗi
chair	ghế
chairman	chủ tịch
chaise lounge	ghế dài
chalice	cốc
chalk	phấn
challenge	thách thức
challenging	đang thách thức
chamber	phòng
chameleon	tắc kè hoa
Champaign	đồng bằng
champion	nhà vô địch
chance	cơ hội
chanced	tình cờ
chancellor	thủ tướng
chances	cơ hội
change	thay đổi
changeable	hay thay đổi
changed	đã (bị) thay đổi
changeover	sự chỉnh lại
changing	đang thay đổi
channel	kênh
chant	ca
chaotic	hỗn loạn
chapel	nhà thờ nhỏ
chaperon	người đi kèm
chapter	chương
char	than
character	nhân vật
characteristic	đặc trưng
characterized	đã đặc trưng
charge	phí
charged	đã (bị)tính phí, tấn công
chariot	xe ngựa
charity	từ thiện
charm	sự quyến rũ
chart	biểu đồ
chase	đuổi bắt
chasm	hang sâu; ngăn cách
chattered	tán dóc; nói chuyện lông bông
chattering	trò chuyện
cheap	rẻ tiền
cheaper	rẻ hơn
cheat	lừa dối
check	kiểm tra
checked	đã (bị) kiểm tra
cheek	má
cheekbone	xương gò má
cheeks	gò má
cheer	cổ vũ
cheerful	vui vẻ
cheering	hoan hô
cheers	chúc sức khỏe
cheery	người vui tánh
chemically	theo cách hóa học
chemise	đồ lót
chemist	nhà hóa học
chemistry	hóa học
chemotherapy	hóa học trị liệu
cherish	yêu mến
cherished	ấp ủ, trân quý
cherry	quả sơ ri
chest	ngực
chestnut	hạt dẻ
chests	những ngực
chevalier	hiệp sĩ
chew	nhai
chewed	đã nhai
chic	sang trọng
chick	con gà con
chicken	con gà
chide	mắng
chief	trưởng
child	trẻ em
childhood	tuổi thơ
childish	như trẻ con
children	trẻ em
chill	thư giãn
chilly	lạnh lẽo
chimney	ống khói
chin	cằm
China	Trung Quốc
chinese	thuộc Trung Quốc
chip	chíp
chipmunk	sóc chuột
chipmunks	loài sóc nhỏ
chiropractor	người nắn bóp
chisel	cái đục
chivalrous	tính hiệp si
chivalrously	tính hiệp si
chlorine	clo
choice	sự lựa chọn
choir	đội hợp ca
choke	làm nghẹt thở
choked	đã (bị) nghẹn ngào, nghẹn thở
choking	nghẹt thở
choose	chọn
chop	bổ, chặt, băm
chopping	đang chặt
chops	những mép, sườn
chopstick	đũa
chore	việc lặt vặt
chorus	hợp ca
chosen	lựa chọn
Christian	đạo tin lành
Christmas	Giáng sinh
chronic	mãn tính
chronicle	sử biên niên
chubby	mũm mĩm
chuckle	cười
chuckling	đang cười
chunk	chunk
chunks	những khối
church	nhà thờ
churn	thùng đánh kem
churned	khuấy tạo ra
churning	khuấy
cigarette	thuốc lá
cinder	xỉ
cinema	rạp chiếu phim
cinematic	điện ảnh
cinnamon	quế
circle	vòng tròn
circled	đã lượn vòng
circles	những vòng tròn
circling	đang vòng quanh
circular	vòng
circulate	truyền
circulatory	lưu thông
circumcise	cắt bao quy đầu
circumcision	cắt bao quy đầu
circus	rạp xiếc
citation	trích dẫn
cities	những thành phố
citizen	công dân
citizens	công dân
city	thành phố
civic	công dân
civil	thường dân
civilian	thường dân
civilization	nền văn minh
civilized	có văn minh
civilizing	văn minh
claim	đòi bồi thường
claims	tuyên bố
clam	con ngao
clamor	kêu la
clamp	cái kẹp
clannish	trung thành
clap	vỗ (tay)
clarify	làm rõ
clarity	làm rõ
clash	cuộc đụng độ
clashed	đã xung đột
clasp	cái móc
clasped	đã siết chặt
class	lớp học
classic	cổ điển
classification	phân loại
classify	phân loại
classmate	bạn học
classroom	lớp học
classy	xuất sắc
claw	cái móc
claws	móng vuốt
clay	đất sét
clean	sạch
cleaned	đã làm sạch
cleanly	sạch sẻ
cleansed	làm sạch
clear	rõ ràng
cleared	xóa
clearing	thanh toán bù trừ
clearly	rõ ràng
cleave	bổ
clenching	siết chặt
clergy	tăng lữ
cleric	giáo sỹ
clerk	thư ký bàn giấy
clerks	thư ký
clever	thông minh
client	khách hàng
cliff	cheo leo
climate	khí hậu
climax	đỉnh điểm
climb	trèo
climbed	đã tăng, leo trèo
climes	những khí hậu
clinch	xác nhận
clinching	nắm chắc, giữ chặt
cling	bám
clinging	bám
clinic	phòng
clip	cái cặp
clipped	đã xén
clipping	đang clipping
cloak	áo choàng
clock	đồng hồ
clockwise	chiều kim đồng hộ
clog	bịt kín
cloister	nhốt
clone	nhân bản vô tính
close	đóng
closed	đã (bị) đóng
closely	chặt chẽ
closer	gần gũi hơn
closet	tủ quần áo
closing	đang đóng cửa
closure	đóng
clot	cục
cloth	vải
clothe	mặc quần áo
clothes	quần áo
clothes-bags	túi quần áo 
clothes-sack	bao quần áo 
cloud	điện toán đám mây
cloudy	có mây
clout	quyền lực không chính thức
clown	người hề
cloy	làm phát ngấy
club	câu lạc bộ
clubbed	đã đập
clubbing	đang đập
clubs	những câu lạc bộ
clue	manh mối
clumsy	vụng về
clung	bám
clutch	ly hợp
clutched	nắm chặt
clutching	đang tay nắm chặt
clutter	tiếng ồn
coach	huấn luyện viên
coal	than
coalition	liên minh
coals	những than
coarse	thô
coarsen	làm thành thô
coast	bờ biển
coastal	ven biển
coastline	đường biển
coat	áo khoác
coated	đã phủ tráng
coats	những áo khoác
coax	dỗ
cobble	chỉnh sửa
cobweb	mạng nhện
cock	gà trống
cockpit	bãi chọi gà
cockroach	con gián
cocky	tự phụ
cocoon	kén
cod	cá tuyết
code	mã số, định luật
coexist	cùng tồn tại
coexistent	cùng tồn tại
coffin	quan tài
cohere	kết lại với nhau
coherent	mạch lạc
cohesion	dính kết
cohesive	dính liền
coil	cuộn
coils	cuộn dây
coin	đồng xu
coincide	trùng với
coincidental	trùng khớp
cold	lạnh
colder	lạnh hơn
coldly	một cách lạnh lùng
collaborate	hợp tác
collage	nghệ thuật cắt dán
collapse	sụp đổ
collapsible	xếp
collar	cổ áo
collarbone	xương đòn
collate	kiểm tra thứ tự
collateral	vật thế chấp
colleague	đồng nghiệp
collect	thu thập
collected	đã thu
collector	người sưu tầm
college	đại học
collide	va chạm
collision	va chạm
colon	kết trực tràng
colonel	thượng tá
colonial	thuộc địa
colonist	người đi khai hoang
colony	thuộc địa
color	màu sắc
colt	ngựa con
column	cột
coma	hôn mê
comb	chải
combat	chiến đấu
combatants	những kẻ tham chiến
combine	kết hợp
combined	đã kết hợp
come	đến
comes	đến
comet	sao chổi
comfort	tiện nghi
comfortable	thoải mái
comfortably	một cách thoải mái
comic	báo tranh chuyện vui
coming	đang đến
comma	dấu phẩy
command	ra lệnh
commandant	sĩ quan chỉ huy
commanded	đã chỉ huy, ra lệnh
commandeer	trưng dụng cho quân đội
commando	đặc công
commemorate	kỷ niệm
commence	bắt đầu
commend	khen ngợi
comment	bình luận
commentator	bình luận
commented	đã (được) nhận xét, góp ý
commerce	thương mại
commercial	thương mại
commingled	trà trộn
commision	tiền hoa hồng
commissary	kho lương thực
commit	cam kết
committee	ủy ban
commodious	rộng rãi
commodity	hàng hóa
commodore	đại tá
common	chung
commotion	chấn động
communal	công cộng
communicable	có thể lây
communicate	truyền đạt
communicated	đã báo tin
communion	quan hệ
commute	đi làm
compact	nhỏ gọn
compactly	nén chặt
companies	những công ty
companion	đồng bạn, người bên cạnh
company	công ty
comparative	so sánh
comparatively	một cách tương đối
compare	so sánh
compared	đã so sánh
comparison	so sánh
compartment	ngăn
compass	la bàn
compassion	lòng thương
compassionate	thương hại
compatible	tương thích
compel	bắt buộc
compellable	bắt buộc
compelled	đã bắt buộc
compelling	thuyết phục
compellingly	hấp dẫn
compendium	bản trích yếu
compensate	bồi thường
compete	cạnh tranh
competent	có thẩm quyền
competition	cạnh tranh
competitive	cạnh tranh
competitor	đối thủ
compile	biên soạn
complain	phàn nàn
complained	phàn nàn
complaint	khiếu nại
compleat	hoàn hảo
complement	bổ sung
complementary	bổ sung
complete	hoàn thành
completely	một cách hoàn toàn
completeness	sự đầy đủ
completion	hoàn thành
complex	phức tạp
compliant	phù hợp với
complicate	phức tạp
complicity	tội đồng lõa
complied	đã tuân thủ
compliment	lời khen
complimentary	dđáng khen
comply	tuân thủ
component	thành phần
comport	xử sự
compose	soạn
composite	ghép lại
composition	hợp thành
compost	phân trộn
composure	bình tĩnh
compound	hợp chất
comprehend	hiểu
comprehensible	dễ hiểu
comprehension	hiểu
comprehensive	tổng hợp
comprehensively	toàn diện
compress	nén
compressed	nén
compressor	máy nén
compromise	thỏa hiệp
compulsion	bắt buộc
compulsive	bắt buộc
compulsory	ép buộc
computation	ước tính
compute	tính toán
comrade	bạn
comradely	một cách bạn bè
comrades	đồng chí
comradeship	tình bạn bè
con	khuyết điểm
conceal	che giấu
concealed	che dấu
concealment	sự che đậy
concede	thừa nhận
conceive	thụ thai
concentrate	tập trung
concept	khái niệm
conception	thụ thai
concern	liên quan
concerned	quan tâm
concerning	liên quan đến
concert	buổi hòa nhạc
concerto	côngxecto
concession	nhượng bộ
conch	ốc biển
conciliate	hoà giải
conciliated	đã hoà giải
concise	ngắn gọn
concision	sự ngắn gọn
conclave	buổi họp kín
conclude	kết thúc
conclusion	kết luận
conclusive	cuối cùng
conclusively	kết luận
concrete	bê tông, chắc chắn
concubine	thê thiếp
concur	tán thành
concurrent	đồng quy
concussion	chấn động
condemn	lên án
condensate	ngưng
condense	ngưng
condiment	gia vị
condition	điều kiện
conditional	có điều kiện
conditions	những điều kiện
condolence	lời chia buồn
condone	bỏ qua
conduct	tiến hành, hành vi
conductor	chất dẫn
cone	hình nón
confederate	liên minh
confer	phong
conference	hội nghị
confess	thú tội
confessed	thú nhận
confidence	sự tự tin
confident	tự tin
confidential	bí mật
confidently	một cách tự tin
configuration	hình dạng
configure	thiết lập cấu hình
confine	giam giữ
confined	đã giới hạn
confines	biên giới
confirm	xác nhận
conflict	xung đột
confront	đương đầu
confuse	gây nhầm lẫn
confused	nhầm lẫn
confusion	sự nhầm lẫn
congenial	thích hợp
congenital	bẩm sinh
congest	tắc nghẽn
congested	bị ngăn trở
congestion	tắc nghẽn
congestive	sung huyết
congratulate	chúc mừng
congratulation	sự chúc mừng
congregate	tụ hợp
congress	đại hội
congressional	quốc hội
congruent	thích hợp
conic	cônic
conifer	cây có quả hình nón
conjectural	căn cứ theo phỏng đoán
conjecture	phỏng đoán
conjoin	nối
conjoint	kết hợp
conjugate	liên hợp
conjunction	liên kết
conjuration	cuộc âm mưu
conjure	gọi hồn
connect	kết nối
conquer	chinh phục
conscience	lương tâm
conscious	có ý thức
consent	đồng ý
consequence	hậu quả
conservatory	nhà kính
conserve	bảo tồn
consider	coi
considerate	quan tâm
consideration	sự xem xét
considered	coi
considering	đang xem xét
consign	giao phó
consignee	người nhận hàng
consignment	lô hàng, hàng gửi
consignor	người gửi hàng
consist	gồm có
consistent	nhất quán
consolation	an ủi
console	an ủi
consolidate	củng cố
consonant	phụ âm
conspicuous	hiển nhiên
conspiracy	âm mưu
conspire	âm mưu
constant	liên tục
constantly	một cách liên tục
consternation	sự kinh hoàng, sự kinh ngạc
constipate	làm táo bón
constitute	thành lập
Constitution	hiến pháp
constrain	ép buộc
constraint	liên kết
constrict	thắt
construct	xây dựng
constructor	người xây dựng
consul	lãnh sự
consular	lãnh sự
consulate	lãnh sự quán
consult	tham vấn
consultant	cố vấn
consultation	tham khảo ý kiến
consume	tiêu thụ
consummate	tài giỏi
contact	liên hệ
contagion	sự truyền nhiểm
contain	chứa
contained	chứa đựng, kềm lại, ngăn lại
container	cái đựng (lọ, chai, bình …)
contaminate	gây ô nhiễm
contemplate	dự tính
contemplation	sự chiêm niệm
contemporary	đương đại
contempt	coi thường
contend	tranh luận
contended	tranh đấu
content	nội dung
contents	những nội dung
contest	cuộc thi
contiguous	tiếp giáp
continent	lục địa
continental	thuộc địa
contingent	bất ngờ
continual	liên tục
continually	một cách liên tục
continue	tiếp tục
continued	đã tiếp tục
continuity	liên tiếp
continuous	liên tục
contour	đường bao quanh
contract	hợp đồng
contracted	đã ký hợp đồng, (bị) nhiễm
contractor	nhà thầu
contraption	máy kỳ cục, mẹo để thay thế tạm thời
contrary	điều trái lại
contrast	sự tương phản
contribute	đóng góp
contribution	đóng góp
control	chủ động kềm chế
controversial	gây tranh cãi
controversy	tranh cãi
convalescence	nghỉ dưỡng, hồi phục
convention	quy ước
converge	cùng quy tụ
conversation	cuộc trò chuyện
converse	trò chuyện
convert	biến đổi
convertible	chuyển đổi được
convey	truyền đạt
conveyance	sự thông tin, bộ phận chuyển kéo
convict	kết án
convince	thuyết phục
convulse	làm rung chuyển
convulsed	co giật
convulsion	chấn động
convulsive	co quắp
cook	nấu ăn
cookie	bánh quy
cooking	đang nấu ăn
cooks	những đầu bếp
cool	nguội, mát
coolant	dung dịch làm nguội
coolly	một cách ung dung bất cần
cooperate	hợp tác
coordinate	phối hợp
cop	cảnh sát
cope	đương đầu
copies	những bản sao chép
copious	phong phú, dồi dào, hậu hỉ
copper	đồng
copy	bản sao
coral	san hô
cord	sợi dây
corduroy	nhung kẻ
core	lõi
cork	nút chai
corn	ngô
corner	góc
cornered	góc
corny	cũ rích
corporal	thuộc cơ thể
corpse	xác chết
corral	lùa vào bãi quây
correct	chính xác
correspond	phù hợp
correspondent	phóng viên
corridor	hành lang
corroborate	làm chứng
corrosion	ăn mòn
corrupt	mục nát
corruption	tham nhũng
cortex	vỏ
cosmetic	thẩm mỹ
cosmic	vũ trụ
cosmopolitan	toàn thế giới
cosmos	vũ trụ
cost	chi phí
costume	trang phục
cosy	làm ấm
cot	giường cũi
cottage	nhà sàn
cottages	căn nhà nhỏ
cotton	bông
couch	ghế
cough	ho
could	đã có thể
couldn't	không thể
council	hội đồng
counsel	lời khuyên
counselor	cố vấn
count	tính, đếm
counted	tính
counter	máy đếm
countered	đã phản đối, đối đáp lại
countless	vô số
country	nước
coup	đảo chính
couple	cặp vợ chồng
courage	can đảm
courageous	dũng cảm
courier	chuyển phát nhanh
course	quá trình, lớp
court	tòa án
courtyard	sân trong
cousin	anh (em) họ
cousins	anh chị em họ
cove	vòm
covenant	hiệp ước
cover	che, cái tấm che
coverage	tin tức
covered	đã phủ
coverings	những  tấm trải
coverlet	khăn trải giường
covert	che lấp
covet	thèm muốn
coveted	đã thèm muốn
cow	bò cái
coward	nhát gan
cowardice	nhút nhát
cows	bò
crab	cua
crack	nứt
cracked	đã nứt
crackled	đã kêu lách tách
crackling	tiếng kêu rắc
cradle	cái nôi
craft	nghề thủ công
craftily	một cách tinh xảo
craftsman	thợ thủ công
cramp	chứng chuột rút
crane	giàn giáo
crank	tay quay
crap	chuyện tào lao
crash	tai nạn
crashed	đã (bị) rơi, bị đụng, đâm sầm
crashing	đang đâm sầm
crass	đần độn
crate	thùng
crater	miệng núi lửa
craters	những miệng núi lửa
crates	những cái thùng gổ
crave	ao ước
craven	hèn nhát
crawl	thu thập dữ liệu
crawled	đã bò
crawling	đang bò
crayfish	tôm
crazed	đã điên rồ
crazy	điên
creak	tiếng cọt kẹt
crease	nếp nhăn
create	tạo ra
creature	sinh vật
creatures	những sinh vật, thú
creche	nhà trẻ
credential	giấy ủy nhiệm
credit	tín dụng, hạnh kiểm
creditor	chủ nợ
creed	tín ngưỡng
creek	sông suối nhỏ
creep	leo
creeping	leo, len
creepy	sởn gai ốc
cremate	hỏa thiêu
crematory	nhà hỏa táng
crept	đã bò lê
crescent	trang lưỡi liềm
crest	vầng
crew	phi hành đoàn
crib	cũi
cricket	bóng chày
crickets	dế
cried	đã khóc
crime	tội phạm
criminal	tên tội phạm
crippled	đã làm tê liệt
crisis	khủng hoảng
crisp	khô teo đi
crispy	giòn
criteria	tiêu chí
critic	nhà phê bình
critical	tối quan trọng
criticize	chỉ trích
crocodile	cá sấu
crone	bà già
crony	bạn chí thân
crook	cái gậy
crop	cây trồng
cross	đi qua
crossed	đã (bị) vượt qua
crosses	đi qua
crossing	đang băng qua
crosswalk	lối sang đường dành cho người đi bộ
crotch	đũng quần
crouch	sự núp, co mình
crouched	đã cúi, co mình
crouching	đang cúi
crow	con quạ
crowd	đám đông
crowded	đông
crowed	đã gáy
crown	vương miện
crucial	quan trọng
crucify	hành hạ
cruel	độc ác
cruelly	độc ác
cruelty	sự tàn ác
cruise	chuyến du lịch trên tàu
crumb	miếng vụn
crumble	đổ nát
crummy	rẻ mạt
crumple	vò nhàu
crumpled	đã vò nát
crunch	giòn nát
crunched	đã làm nát
Crusade	chiến dịch
crush	đè bẹp
crushing	nghiền, đè bẹp
crushingly	một cách mãnh liệt
crust	lớp vỏ
crutch	cái nạng
cry	kêu, khóc
crying	đang khóc
cryptogram	tài liệu viết bằng mật mã
crystal	pha lê
cub	con thú con
cube	cục
cucumber	dưa chuột
cuddle	cuộn mình
cue	ám chỉ
cuff	cổ tay áo
cuisine	nấu ăn
culinary	nấu ăn
culprit	thủ phạm
culprits	những thủ phạm
cultivate	canh tác
culture	văn hóa
cumulate	tích lũy
cumulus	mây tích
cunning	đầy mưu kế
cunningly	một cách tinh khôn
cup	cốc, tách, chén
cupboard	tủ quần áo
curb	kiềm chế
curdle	đóng cục
cure	chữa bệnh
curfew	lệnh giới nghiêm
curiosity	tò mò
curious	tò mò
curiously	một cách tò mò
curled	đã cuốn lên
curly	quăn
current	hiện tại
curriculum	chương trình giảng dạy
curse	chưởi rủa
cursed	đã nguyền rủa
curses	(những) nguyền rủa
cursing	đang nguyền rủa
curve	đường cong
curved	đã cong
curving	đang cong
custody	giám hộ
custom	tùy chỉnh
customary	thông thường
customer	khách hàng
cut	cắt
cute	dễ thương
cuts	(những) xén, cắt (giảm)
cutting	cắt
cycle	chu kỳ
cylinder	hình trụ
cyst	u nang
dad	bố
daffodil	cây thủy tiên hoa vàng
dagger	dao găm
daily	hàng ngày
dainty	ngo
dairy	cửa hàng bơ sữa
dam	đê
damage	thiệt hại
damn	khốn kiếp
damnation	sự đọa đày
damp	ẩm ướt
dams	đập nước
dance	nhảy
dancing	nhảy múa
dandelion	cây bồ công anh
dandruff	gầu
danger	nguy hiểm
dangerous	nguy hiểm
dangle	đeo đuổi
Danish	Đan-mạch
dare	dám
dared	đã dám
dark	tối
darken	làm u ám
darkness	bóng tối
darling	yêu quý
darn	mạng
dart	mũi tên
darted	lao, phóng
dash	phóng
dashboard	cái chắn bùn
dashed	đã phóng
dastard	kẻ hèn nhát
data	dữ liệu
date	ngày tháng
daughter	con gái
daughter in law	con dâu
daughters	những con gái
daunted	đã nản lòng
dawn	bình minh
day	ngày
daybreak	rạng đông
daydream	mơ mộng
daylight	áng nắng ban ngày
days	những ngày
days'	của những ngày
day's	của ngày
daytime	ban ngày
daze	sửng sốt
dazed	đã (bị) choáng váng
dazzle	làm lóa mắt
deacon	người trợ tế
deactivate	làm ngừng hoạt động
dead	chết
deadline	thời hạn
dead-tiredness	mệt mỏi đến như chết
deaf	điếc
deal	giải quyết
dealers	đại lý, tay buôn
dealt	đã (bị) xử lý
dean	hiệu trưởng
dear	thân yêu
dears	yêu quý
death	cái chết
death penalty	án tử hình
deathless	bất tử
death-struggle	cuộc đấu tranh sống chết 
debase	hạ thấp giá trị
debate	tranh luận
debit	ghi nợ
debris	mảnh vụn
debt	món nợ
debtor	người nợ
debts	các khoản nợ
debut	trình diễn đầu tiên
decade	thập kỷ
decadent	sa sút
decay	mục rữa
decease	làm giảm
decedent	người đã chết
deceit	lừa gạt
deceive	lừa gạt
decelerate	đi chậm lại
December	Tháng mười hai
decennial	mười năm một lần
decent	đứng đắn
deception	lừa bịp
decide	quyết định
decided	đã (được) quyết định
decidedly	sự phân biệt rỏ rệt
decimal point	dấu phẩy thập phân
decipher	giải mẵ
decision	quyết định
decisive	quyết định
decivilization	sự suy thoái văn minh
deck	boong
declare	khai báo
declination	độ lệch
decline	suy giảm
decode	giải mã
decomposable	có thể phân hủy được
decompose	phân hủy
decorate	trang trí
decorous	hã nhặn
decrease	giảm
decree	sắc lệnh
decry	chỉ trích
dedicate	cống hiến
deduce	suy lunj
deduct	khấu trừ
deductible	có thể khấu trừ
deed	chứng thư
deeds	hành động
deem	coi
deep	sâu
deepen	làm sâu sắc
deeper	sâu hơn
deeps	những vực sâu
deer	nai
deerhound	loài chó săn nai
default	mặc định
defeat	thất bại
defect	khiếm khuyết
defence	sự phòng thủ
defend	bảo vệ
defendant	người bị kiện
defended	đã bảo vệ
defending	đang bảo vệ
defense	sự bảo vệ
defensive	tự vệ
defer	hoãn
deferred	chờ kết chuyển
defiance	sự thách chiến
defiant	ngang ngạnh
defiantly	thách thức, kiên cường
deficient	sự thiếu
deficit	số tiền thâm hụt
defied	đã thách thức
define	xác định
definite	xác định
definition	định nghĩa
deflate	xì hơi
deflect	làm chệch hướng
deflector	máy đo từ thiên
deform	làm biến dạng
defrost	rã đông
deft	khéo tay
defy	bất chấp
defying	bất chấp
degenerate	thoái hóa
degrade	thoái hóa
degree	độ
dehumidify	làm giảm độ ẩm
dehydrate	làm mất nước
deify	sùng bái
deity	thượng đế
deject	làm thất vọng
dejected	chán nản
delay	trì hoãn
delayed	đã (bị) trì hoãn
delectable	ngon
delectate	vui thích
delegable	có thể ủy quyền
delegate	phái đoàn
delete	xóa
deliberate	thận trọng
deliberately	một cách cố ý
deliberateness	sự cố ý
delicacy	duyên dáng
delicate	tinh vi
delicious	ngon miệng
delight	hân hoan
delights	những sự thích thú
delinquent	phạm tội
delirious	hôn mê
delirium	mê sảng
deliver	cung cấp, giao
delivery	giao hàng
delivery man	người đàn ông giao hàng
delta	hình tam giác
delude	lừa dối
deluge	dồn dập
deluged	đã ngập lụt
delusion	ảo tưởng
deluxe	sang trọng
delve	nghiên cứu sâu
demand	nhu cầu, yêu cầu
demanded	đã (bị) yêu cầu
demanding	đang yêu cầu
demean	hạ mình
demented	mất trí
demerit	khuyết điểm
demesne	lảnh thổ
demigod	á thần
demise	nhượng lại
demit	thôi việc
democracy	dân chủ
democratic	dân chủ
demolish	phá hủy
demolition	phá hủy
demon	yêu tinh
demoniac	bị ma ám
demonic	xuất quỷ nhập thần
demonstrable	có thể chứng minh được
demonstrate	chứng minh
demonstrative	phô trương
demote	giáng cấp
demur	phản đối
demure	từ tốn
demurrer	bác bỏ
den	ổ
deniable	có thể khước từ
denial	từ chối
denied	bị từ chối
denigrate	chê bai
denotation	ký hiệu
denote	biểu thị
denouement	kết cục
denounce	lên án
dense	ngu si
dental	nha khoa
dentist	Nha sĩ
dentistry	khoa răng
denture	hàm răng
denude	lột trần
denunciate	tố cáo
deny	từ chối
deodorant	chất khử mùi
depart	từ trần, từ giã, chết
departed	đã ra đi
department	phòng
department store	cửa hàng bách hóa
departs	khởi hành
departure	ra đi
depend	phụ thuộc
dependent	phụ thuộc
depending	tùy thuộc
depict	miêu tả
deplete	rút hết
depletion	hút cạn
deplore	xót xa
deploy	triển khai
deport	trục xuất
deportation	trục xuất
deportee	người bị trục xuất
depose	cách chức
deposit	tiền gửi
depositary	người giữ đồ gửis
deposited	đã gửi
depositor	người gửi tiền
depository	kho
deposits	(những tiền) gửi
depot	kho
deprave	làm hư hỏng
deprecate	phản đối
deprecatory	cáo lỗi
depreciable	có thể bị giảm giá trị
depreciate	giảm giám trị
depress	làm suy giảm
depressant	giảm đau
depressed	làm phiền muộn
depressing	buồn rầu
depression	phiền muộn
depressor	chất giảm vận động
deprivation	tước đoạt
deprive	tước đoạt
depth	chiều sâu
depths	độ sâu
depute	giao
derail	làm trật bánh
derange	làm trục trặc
derelict	bị bỏ rơi
deride	cười nhạo
derision	chế nhạo
derisive	chế nhạo
derive	lấy được
dermatologist	bác sĩ da liễu
derogate	làm giảm
derogatory	xúc phạm
descend	đi xuống
descendant	con cháu
descended	đã xuống
descendent	con cháu
descent	sự hạ xuống, gốc
describe	mô tả
described	đã mô tả
description	mô tả
descriptive	mô tả
desecrate	báng bổ
desecrater	người báng bổ
desert	rời bỏ
deserted	hoang vu, bỏ rơi
deserve	xứng đáng
deserved	đã xứng đáng
desideratum	ước nguyện
design	thiết kế
designate	bổ nhiệm
desire	ham muốn
desired	đã ham muốn
desires	mong muốn, ham muốn
desirous	khát khao
desist	ngừng
desk	bàn
desolate	đổ nát
desolated	hoang vu
despair	tuyệt vọng
despatches	những công tác
desperado	kẻ liều mạng tuyệt vọng
desperate	tuyệt vọng
desperately	tuyệt vọng
desperation	sự tuyệt vọng
despicable	hèn hạ
despise	khinh khi
despite	mặc dù
despoil	chiếm đoạt
despond	thất vọng
despondent	thất vọng
despot	kẻ chuyên quyền
despotic	chuyên chế
dessert	món tráng miệng
destabilize	làm mất ổn định
destine	dự định
destined	đã mệnh
destiny	số phận
destitute	không có
destroy	phá hủy
destroyed	đã bị phá hủy
destroying	phá hủy
destruct	phá hủy
destruction	phá hủy
destructor	hủy
desuetude	lỗi thời
desultory	lung tung
detach	gỡ ra
detail	chi tiết
details	chi tiết
detain	giam giữ
detect	phát hiện
detection	phát hiện
detector	máy dò
detent	cái chốt
detention	giam giữ
deter	ngăn chặn
detergent	chất tẩy rửa
deteriorate	làm xấu hơn
determinant	quyết định
determinate	xác định
determine	xác định
determined	xác định
determining	xác định
detest	ghét
detestable	đáng ghét
detonable	có thể nổ
detour	tránh
detoxify	giải độc
detract	làm giảm
devastate	phá hủy
develop	phát triển
developed	đã (bị) phát triển
development	sự phát triển
deviant	lệch lạc
deviate	trệch
device	thiết bị
devil	quỷ
devilish	độc ác
devils	những con quỷ
devious	thủ đoạn
devise	nghĩ ra
devoid	không có
devolve	trút
devote	cống hiến
devotion	tận tâm
devour	ngấu nghiến
devoured	đã nuốt chửng
devout	sùng đạo
dew	giọt sương
dewy	đẫm sương
dexter	bên phải
dexterity	khéo léo
diabetes	bệnh tiểu đường
diabetic	người mắc bệnh tiểu đường
diabolic	ma quỷ
diabolically	một cách hiểm ác
diadem	vương miện
diagnosable	có thể chẩn đoán được
diagnose	chẩn đoán
diagnosis	chẩn đoán
diagonal	chéo
diagram	sơ đồ
diagrammatic	bằng biểu đồ
dialogue	cuộc đối thoại
dialysis	thẩm tách
diamagnetic	nghịch từ
diamagnetism	tính nghịch từ
diameter	đường kính
diamond	kim cương
diaper	bỉm
diaphanous	trong suốt
diaphragm	màng ngăn
diary	nhật ký
diathermy	phép điện nhiệt
diathesis	tạng
dice	súc sắc
dictate	ra lệnh
dictating	đưa ra mệnh lệnh
dictatorial	độc tài
diction	cách diễn tả
dictionary	từ điển
dictum	châm ngôn
did	đã làm
die	chết
died	đã chết
diet	chế độ ăn uống
dietary	ăn kiêng
dietetic	ăn kiêng
dietician	chuyên gia dinh dưỡng
differ	khác biệt
different	khác nhau
differential	chênh lệch
differentiate	phân biệt
difficult	khó
difficulty	khó
diffident	nhút nhát
diffuse	khuếch tán
dig	đào
digest	tiêu hóa
digestible	dễ tiêu thụ
digestion	khả năng tiêu hóa
digestions	tiêu hoá
digging	đang đào
dignified	tôn trọng
dignify	phẩm cách
dignitary	người quyền cao
dignity	phẩm cách
digress	lạc đề
dilapidate	làm đổ nát
dilate	Làm giãn
dilatory	chậm chạp
dilemma	thế tiến thoái lưỡng nan
diligent	siêng năng
diluent	sự hòa tan
dilute	pha loãng
dilution	làm loãng
dim	âm u
dimension	kích thước
diminish	giảm bớt
diminished	giảm bớt
diminution	sự giảm
diminutive	nhỏ
dimly	một cách lờ mờ
dimmed	mờ đi
dimple	lúm động tiền
din	kêu vang lên
dine	ăn cơm
dinner	bữa ăn tối
dinnerware	bộ đồ ăn
dinosaur	khủng long
diocese	giáo khu
dip	nhúng
diploma	cử nhân
diplomacy	ngoại giao
diplomat	nhà ngoại giao
diplomatic	ngoại giao
dipole	lưỡng cực
dire	thảm khốc
direct	trực tiếp
directing	chỉ đạo
direction	hướng
directions	hướng
directly	một cách trực tiếp
directness	ngay thẳng
director	Giám đốc
directorate	ban giám đôc
directory	danh bạ
dirt	vết bẩn
dirty	dơ bẩn
disagree	không đồng ý
disappear	biến mất
disappeared	đã biến mất
disappearing	đang biến mất
disappoint	thất vọng
disappointment	thất vọng
disapprove	không tán thành, phản đối
disarm	giải ráp vũ khí
disaster	thảm họa
disburdened	giải phiền, gở phiền
disburse	giải ngân
discard	loại bỏ
discarded	đã bị loại bỏ
discern	phân biệt
discernible	có thể thấy rõ
discharge	xả
discharged	thải
discharging	xả
disciple	môn đồ
disciplinary	kỷ luật
discipline	kỷ luật
disciplining	đang xử lý kỷ luật
disclosed	tiết lộ
discoid	hình đĩa
discolored	đổi màu
discomfit	làm bối rối
discomfited	bối rối
discomfiture	kinh ngạc
disconsolate	ảm đạm
discordant	không hòa hợp
discount	giảm giá
discourage	ngăn cản
discover	khám phá
discovered	đã phát hiện
discovery	khám phá
discreet	kín đáo
discrepant	trái ngược nhau
discrete	riêng biệt
discretion	tùy ý
discretionary	tùy nghi
discriminable	có thể phân biệt được
discriminant	biệt số
discriminate	phân biệt
discuss	thảo luận
discussant	người điều hành thảo luận
discussion	thảo luận
disdain	coi thường
disgruntle	làm cáu kỉnh
disguise	cải trang
disgust	sự kinh tởm
dish	món ăn
dishes	món ăn
dishevel	làm xõa ra
dishonor	sỉ nhục
dishwasher	máy rửa bát
dismal	phiền muộn
dismay	sự mất tinh thần
dismiss	miễn nhiệm, sa thải
dismissal	sa thải
disorder	rối loạn
disparage	xem thường
disparate	tạp nham
dispel	xua tan
dispensable	có thể bỏ qua
dispensary	trạm phát thuốc
dispense	pha chế và cho
dispersal	phân tán
disperse	phân tán
dispersible	có thể phân tán được
displaced	đã di dời
display	hiển thị
displeasure	không vừa lòng
disposable	dùng một lần
disposal	sự bỏ đi, thải đi
dispose	xử lý
disputant	người tranh luận
dispute	tranh chấp
disqualify	truất quyền
disquietude	cảm giác bất an
disquisition	tài liệu nghiên cứu công phu
disrupt	phá hỏng
disrupted	đã bị gián đoạn
disruption	ngắt
distance	khoảng cách
distant	xa xôi
distillate	sản phẩm chưng cất
distillery	nhà máy rượu
distinct	dứt khoát
distinguish	phân biệt
distort	bóp méo
distortion	sự bóp méo
distract	làm xao nhãng, đánh lạc hướng
distraught	quẫn trí
distribute	phân phối
distributed	đã phân phối
distribution	phân phối
distributor	nhà phân phối
district	khu vực
disturb	quấy rầy
disturbance	rối loạn
ditch	máng
dither	lay động
ditto	như trên
ditty	bài hát ngắn
diurnal	ban ngày
dive	lao xuống
diverge	khác
divergent	rẽ
divers	những thợ lặn
diverse	đa dạng
diversify	đa dạng hóa
diversion	chệnh hướng
divest	tước bỏ
divide	chia
dividend	cổ tức
divides	chia
divination	lời tiên đoán
divine	thiêng liêng
divined	thiêng liêng
divisible	có thể chia được
division	phân chia
divorce	ly hôn
divorcee	người ly dị
divulge	tiết lộ
dizzy	choáng váng
do	làm
docilely	một cách ngoan ngoãn
dock	cảng
doctor	bác sĩ
doctoral	tiến sỹ
doctorate	học vị tiến sỹ
doctrinaire	giáo điều
doctrinal	học thuyết
doctrine	học thuyết
document	tài liệu
documentary	phim tài liệu
documentation	hồ sơ
dodge	né
dodged	đã né
doe	hươu cái
dog	con chó
dog-breakin'	luyện chó
dog-busters	những tay bắt chó
dog-doctor	bác sĩ chó 
dog-driver	người lái xe chó
dog-food	thức ăn chó
dogma	giáo lý
dogmatic	độc đoán
dogmatism	chủ nghĩa giáo điều
dogs	những con chó
dogs'	của những con chó 
dog-teams	những đội chó
dogtrot	nước kiệu nhẹ nháng
doing	đang làm
dolce	êm ái
doldrum	buồn chán
doll	búp bê
dollars	đô la
dollop	miếng to
dolphin	cá voi
dolt	người đần độn
domain	tên miền
dome	mái vòm
domestic	trong nước, nội địa
domesticated	đã (được) thuần hóa
domicile	nơi ở
dominant	ưu thế, trội, loài mạnh
dominate	thống trị
dominion	sự ảnh hưởng
donate	tài trợ
done	đã thực hiện
donkey	con lừa
donor	người hiến
don't	không làm
doom	diệt vong, tận thế
door	cửa
doors	những cái cửa
dormant	ngủ đông
dormitory	ký túc xá
dosage	liều
dose	liều (thuốc)
dossier	hồ sơ
dot	dấu chấm
dote	mê mẩn
double	đôi
doubled	đã tăng gấp đôi
doubling	tăng gấp đôi
doubt	nghi ngờ
dough	bột nhào
dove	chim bồ câu
dowager	người thừa kế tước hiệu của chồng
down	xuống
down-coming	xuống tới
downhill	xuống dốc
downplay	coi nhẹ
downpour	mưa rào
downslope	dốc xuống
downstairs	trên tầng
downstream	xuôi dòng
down-stream	hạ lưu
downtown	ở thành phố
downward	hướng xuống
dowry	tài năng
doze	ngủ gà ngủ gật
dozen	hàng chục
dozing	ngủ gật
drab	sa sút
draft	dự thảo
drag	kéo
dragged	đã (bị) kéo
dragging	đang kéo
draggled	đã kéo lết phết
dragon	con rồng
dragonfly	chuồn chuồn
drain	mương, rãnh
drainage	hệ thống thoát nước
drake	vịt đực
drama	vở kịch cho sân khấu
dramatic	kịch tính
dramatization	viết thành kịch
drank	đã uống
drape	rèm
draped	đã phủ lên
drapery	vải vóc
drastic	mạnh mẽ
draught	gió lùa, vận rủi
draw	vẽ
drawer	ngăn kéo
drawing	đang vẽ, kéo ra
drawl	nói lè nhè
drawn	đã rút ra
dread	kinh sợ
dream	giấc mơ
dreamed	mơ ước, ngủ mơ
dreamily	một cách tưởng tượng
dreaming	đang mơ
dreamlike	lung linh
dreams	những giấc mơ
dreamy	mờ mịt
dreary	thê lương
dreg	chút xíu còn lại
drench	làm ướt sũng
dress	váy
drew	đã thu hút, đã vẽ
dribble	rê bóng
dried	khô
drift	trôi dạt
drifted	trôi dạt
drifting	đang trôi
driftwood	gổ trôi dạt
drink	uống
dripping	đang rỉ nước
drive	lái (xe)
driven	đã điều khiển, (được) thúc đẩy
driver	tài xế
drivers	người điều khiển
drives	lái, đẩy
driveways	đường lái xe vào nhà
driving	đang lái xe
droll	khôi hài
drool	nước dãi
drooped	buông
drooping	đang gục xuống
drop	rơi
dropped	đã (bị) giảm, hạ
dropping	thả
drought	hạn hán
drove	đã lái xe
drown	chết đuối
drowned	đã (bị) chết đuối
drowse	làm ngập nước
drudge	làm vất vả
drudgery	công việc vất vả
drum	trống
drumming	trống
drunken	say rượu
dry	khô
dub	lông tiếng
dubious	không đáng tin cậy
dubiously	một cách nghi ngờ
duck	con vịt
duckling	vịt con
ductile	dễ uốn
dud	bỏ đi
due	do, bởi vì, tại
duel	cuộc đấu (kiếm, súng) tay đôi
duet	bản đuyê
duffel	vải len thô
dug	đào
duke	công tước
dulcet	êm ái
dull	ngu đần
dully	đều đều
dumb	câm
dumbbell	quả tạ
dummy	giả
dump	đổ (rác)
dumped	bán phá giá, đổ bỏ
dumpling	bánh bao
dune	cồn cát
duplicate	nhân đôi
duplicated	đã nhân đôi
durable	bền
during	đang trong khi
dusk	hoàng hôn
dust	bụi
dustbin	thùng rác
dusty	bụi
duties	những nhiệm vụ
dutiful	biết vâng lời
duty	nhiệm vụ
dwarf	lùn
dwelling	ở
dwindle	thu nhỏ lại
dwindled	cạn dần
dyadic	nhị nguyên
dye	thuốc nhuộm
dying	đang chết
dynasty	triều đại
dysentery	bệnh lỵ
dyspeptic	khó tiêu
each	mỗi
eager	háo hức
eager-eyed	mắt háo hức
eagerly	một cách háo hức
eagerness	sự háo hức
eagle	chim ưng
ear	tai
eardrum	màng nhĩ
earl	bá tước
earlier	trước đó
early	sớm
earmark	đánh giấu riêng
earned	đã thu được
earnest	nghiêm trang
earring	bông tai
ears	những lổ tai
earth	đất
earthen	bằng đất
earthenware	đồ bằng đất nung
earthquake	động đất
earthworm	giun đất
ease	dễ dàng
easel	khung vẽ
easier	dễ dàng hơn
easily	một cách dễ dàng
east	hướng đông
eastbound	về hướng đông
eastward	phía đông
easy	dễ dàng
easygoing	dễ tính
eat	ăn
eatable	ăn được
eaten	đã ăn
eater	người ăn
eating	đang ăn
eavesdrop	nghe trộm
ebb	triều xuống
ebbed	đã giảm xuống
ebony	gỗ mun
eccentric	người lập dị
echelon	bậc
echinoderm	động vật da gai
economy	nền kinh tế
ecstasy	sự ngây ngất
eddies	những xoáy nước
eddy	xoáy
edelweiss	cây nhung tuyết
edge	viền, cạnh, mí
edgewise	từ phía bên cạnh
edible	ăn được
edict	sắc lệnh
edify	khai trí
edit	hiệu đính
educate	giáo dục
eerie	kỳ quái, ớn sợ
efface	làm lu mờ
effect	hiệu quả, tác dụng, hiệu lực
effectually	có hiệu quả, có kết quả
effete	bất lực
efficacious	hiệu quả
efficacy	hiệu quả
efficient	hiệu quả
effort	công sức
efforts	nỗ lực
egg	quả trứng
ego	cái tôi
egotistical	tự cao tự đại
egress	lối ra
eight	tám
eighteen	18
either	hay
ejaculate	phóng ra
elbow	khuỷu tay
elbows	những khuỷu tay
election	bầu cử
electric	(thuộc) điện
electrify	làm giẩy nảy người
electrocardiogram	điện tâm đồ
electrocardiograph	máy ghi điện tim
electrode	điện cực
elementary	dễ hiểu
elementary school	trường tiểu học
elementry	dễ hiểu
elevate	nâng lên
elf	yêu tinh
eliminate	loại bỏ
elimination	loại bỏ
eloquent	có tài hùng biện
eloquently	hùng hồn
else	khác
embark	dấn mình vào
embrace	ôm chầm
embracing	ôm chầm
emergency	khẩn cấp
emergency room	phòng cấp cứu
emigrate	di cư
emotion	cảm xúc
emphasis	nhấn mạnh
employ	thuê (làm)
emptied	làm trống
emptiness	sự trống rỗng
empty	trống rỗng
enable	cho phép
enabled	đã (bị) tạo khả năng
enclose	kèm theo
encountered	đã gặp phải
encourage	khuyến khích
encouraged	khuyến khích
encouragement	sự khuyến khích
encouraging	khuyến khích
encyclopedia	bách khoa toàn thư
end	cuối
endanger	gây nguy hiểm
ended	kết thúc
ending	kết thúc
endless	vô tận
endorse	chứng thực
ends	kết thúc
endure	chịu được
endured	đã (bị) chịu đựng
enduring	lâu dài
enemy	kẻ thù
enemy's	của đối phương
enforce	thực thi
enforcing	đang thực thi
engage	hứa hẹn
England	nước Anh
english	tiếng Anh
enjoy	thích
enormous	to lớn, khổng lồ
enormousness	kếch xù, vĩ đại
enough	đủ
enrich	làm giàu
ensure	đảm bảo
enter	nhập, vào
entered	đã vào
entertain	giải trí
enthusiastically	một cách nhiệt tình
enticed	dụ dỗ
entire	toàn bộ
entrance	lối vào
entreated	thỉnh cầu, nài xin
entry	nhập cảnh
envelope	phong bì
enveloped	đã bao bọc
enveloping	bao bọc
environment	môi trường
envy	ghen tị
epidemic	dịch bệnh
equal	như nhau, bằng nhau
equally	một cách bằng nhau
equilibrium	trạng thái cân bằng
equivalent	tương đương
erase	tẩy xóa
ere	trước
erect	dựng lên, đứng thẳng
errand	việc lặt vặt
errands	việc vặt
error	lỗi
escape	thoát
escaped	đã thoát
escorted	đã (được) hộ tống
especial	riêng đặc biệt
especially	đặc biệt là
essay	bài luận
essence	bản chất
essencial	thiết yếu
essential	cần thiết
establish	thành lập
estate	bất động sản
estimate	ước lượng
estimation	sự dự toán
eternal	vĩnh cửu
eternity	vĩnh cửu
ethical	đạo đức
evacuate	sơ tán
eve	đêm trước
even	thậm chí, huề
evening	buổi tối
event	sự kiện
events	sự kiện
ever	bao giờ
every	mỗi
everybody	tất cả mọi người
everyday	hàng ngày
everything	tất cả mọi thứ
everywhere	ở khắp mọi nơi
evidence	bằng chứng
evidenced	đã chứng minh
evident	hiển nhiên
evil	cái ác
evil-looking	ác
evil-tempered	ác tính
evinced	tỏ ra
exact	chính xác
exaggerate	phóng đại
exam	thi
examine	kiểm tra
examined	kiểm tra
examining	đang kiểm tra
example	ví dụ
exceed	vượt quá
excelled	đạt xuất sắc
excellent	tuyệt vời
except	ngoại trừ
exception	sự ngoại lệ
excess	quá mức
excessive	quá mức
exchange	trao đổi
exchanged	đã trao đổi
excite	kích thích
excited	đã (bị) kích thích
excitedly	một cách hào hứng
excitement	sự phấn khích
exclaim	kêu lên
exclamation mark	dấu chấm than
exclamations	những tiếng kêu
exclusion	loại trừ
excrescence	cục u, u lồi
excuse	tha lỗi
Excuse me	xin lỗi
execute	thực hiện, chạy
exempt	miễn thuế
exercise	thể dục
exertion	sự rán sức
exhale	bốc lên
exhausted	đã kiệt sức
exhausting	đang kiệt quệ
exhibition	triển lãm
exist	tồn tại
existence	sự tồn tại
exit	lối ra
expand	mở rộng
expect	mong đợi
expectant	trông mong
expected	đã dự kiến
expecting	đang mong đợi
expediency	phương tiện, có lợi, tính thiết thực
expense	chi phí
expensive	đắt tiền
experience	kinh nghiệm
experienced	đã kinh nghiệm
experiment	thử nghiệm
expire	hết hạn
explain	giải thích
explode	phát nổ
exploit	khai thác
explore	khám phá
export	sự xuất khẩu
express	thể hiện, nhanh chóng
expressed	bày tỏ
expressing	đang thể hiện
expression	sự biểu hiện
exquisite	tinh tế
extend	mở rộng
extension	sự mở rộng
extention	sự gia hạn
extermination	tiêu diệt
external	bên ngoài
extinct	tuyệt chủng
extra	thêm
extract	chiết xuất
extracted	đã chiết xuất
extracurricular activity	hoạt động ngoại khóa
extraordinary	bất thường
extreme	cực
extremity	bộ phận đầu chóp ngón tay, mũi; hoàn cảnh cùng cực
exultantly	một cách phấn khởi
eye	mắt
eye glass	mắt kính
eye measurement	đo mắt
eyebrow	lông mày
eyeglass	kính đeo mắt
eyelid	mí mắt
eyes	những con mắt
fabled	ngụ ngôn
face	mặt
faced	đã (bị) đối mặt
facility	cơ sở vật chất
facing	phải đối mặt với
fact	thực tế
factor	nhân tố
factory	nhà máy
facts	những sự kiện
faculty	khoa
fade	phai
fading	mờ dần
fail	thất bại
failed	đã thất bại
failing	thất bại, không làm
fails	thất bại, không làm
failure	thất bại
faint	mờ nhạt
fainter	mờ hơn
faintest	mờ nhạt, mong manh nhất
faintly	phơn phớt, mờ nhạt
fair	công bằng
fairly	khá
fairy	cổ tích
fairy tale	chuyện cổ tích
faith	đức tin
faithful	trung thành
faithfully	một cách trung thành
faithfulness	lòng trung thành
fake	giả
fake sickness	ốm giả vờ
fall	rơi
fallen	đã rơi
falling	đang giảm, rơi
fame	danh tiếng
familiar	quen thuộc
familiarity	sự quen thuộc
family	gia đình
famine	nạn đói
famished	đã chết đói
famous	nổi tiếng
fan	quạt
fancy	đẹp
fang	răng nanh
fanged	cắm nanh
fangs	những răng nanh
fanned	đã quạt
fantasy	hình ảnh tưởng tượng
far	xa
fare	ăn, gặp phải hoàn cảnh
fared	đã ở tình trạng
farm	trang trại
farmer	nông dân
farther	xa hơn
farthest	xa nhất
fashion	thời trang
fashions	những thời trang
fast	nhanh
fasten	buộc, thắt
fastened	đã gắn chặt
faster	nhanh hơn
fastidiousness	sự kén chọn
fat	chất béo
fatal	gây tử vong
fate	số phận
fateful	lời tiên tri, thuộc số mệnh
father	cha
father in law	bố chồng ( bố vợ)
fathered	làm cha
fathers	những người cha
fatigue	mệt mỏi
faucet	vòi nước
fault	lỗi
favor	ủng hộ
favored	đã (được) ưa chuộng
favorite	yêu thích
favors	ủng hộ
fawn	hươu con
fawned	đã khúm núm
fear	sợ
feared	đã sợ
fearful	sợ hãi
fearfully	kinh hải
fearlessly	(một cách) không sợ hãi
feasted	ăn tiệc
feat	kỳ công, chiến công
feather	lông chim
feathered	bằng lông chim
feathers	lông chim
feature	tính năng
February	Tháng hai
fed	đã (cho) ăn
fee	lệ phí
feebly	yếu ớt
feed	nuôi
feel	cảm thấy
feeling	cảm thấy
feelings	những cảm xúc
feet	chân
feets	những bàn chân
feigned	giả mạo
fell	đã (bị) té, giảm, rơi
fellow	đồng bạn
fellows	kẻ đồng bạn, người ngang hàng
fellowship	tình đồng bạn, học bổng
felt	đã (bị) cảm thấy
female	nữ
feminine	nữ tính
fence	hàng rào
ferocious	dã man
ferocity	tính dữ tợn, tính hung ác
ferry	chiếc phà
fertile	màu mỡ
fertilizer	phân bón
fervently	nhiệt thành
festive	lễ hội
fetch	lấy
fetching	đang lấy/nhặt, đang làm say mê
fever	cơn sốt
feverish	nóng nảy
few	vài
fiber	sợi
fibre	sợi
fiction	viễn tưởng
fidelity	tính trung thực
field	lĩnh vực
fiend	kẻ có khả năng xuất quỷ nhập thần
fierce	khốc liệt
fiercely	một cách quyết liệt
fierceness	sự dữ dằn
fiercer	khốc liệt hơn
fiercest	ác liệt
fifteen	15
fifth	thứ năm
fifty	năm mươi
fifty pound	£ 50
fifty-mile	50 dặm
fifty-pound	50-pao
fight	chiến đấu
fighter	chiến sĩ
fighters	những chiến sĩ
fighting	đang chiến đấu
fights	(những cuộc) chiến đấu
figure	suy ra, con số
file	tập tin
filing	nộp hồ sơ
fill	điền
filled	đã làm đầy
fills	lấp đầy
filter	bộ lọc
fin	vây
final	cuối cùng
finally	cuối cùng
finance	tài chính
find	tìm
finding	tìm kiếm
fine	tốt
finely	một cách mịn, sang trọng
finger	ngón tay
fingerprint	dấu vân tay
fingers	những ngón tay
finish	kết thúc
finished	đã kết thúc
finishing	đang hoàn thành
fire	lửa
fire station	trạm cứu hỏa
fireman	lính cứu hỏa
fireplace	lò sưởi
fires	những ngọn lửa
fire-scorched	đã (bị) cháy sém
firewood	củi
firm	công ty
first	thứ nhất
first aid	sự sơ cứu
first lady	Đệ nhất phu nhân
fish	con cá
fished	đánh bắt
fisherman	ngư dân
fishing	đánh bắt cá
fish-sacks	bao tải cá
fishy smell	mùi tanh
fissures	vết nứt
fist	nắm tay, nắm đấm
fit	phù hợp với
fits	phù hợp với, vừa
fitting room	phòng thử quần áo
five	năm
fivescore	100
fix	sửa chữa
fixed	đã cố định
fixture	sự cố định
flag	cờ
flagged	gắn cờ, vẫy cờ
flake	bông
flame	ngọn lửa
flames	những ngọn lửa
flaming	đang cháy
flank	hông
flanks	những bên sườn
flap	vỗ
flapped	đã đập, vỗ
flare	lóe lên
flash	lóe sáng
flashed	đã lóe sáng
flashing	đang nhấp nháy
flat	phẳng
flattened	phẳng, làm thẳng
flatter	tâng bốc
flavor	hương thơm
flea	con bọ chét
flecked	đã đốm
fled	đã chạy trốn
flee	chạy trốn
fleeing	chạy trốn
fleeting	không lâu dài
flesh	thịt
flew	đã bay
flexible	linh hoạt
flickered	chập chờn
flies	bay
flight	chuyến bay
fling	chạy vụt ra
flint-lock	khoá súng hồi xưa
flirted	tán tỉnh
flitted	lướt
float	phao
flock	bầy đàn
flood	lũ lụt
floor	sàn
floral	hoa
floss	chỉ tơ
flounder	chạy lung tung
floundered	lúng túng
flour	bột
flower	hoa
flowers	hoa
flowing	đang trôi/chảy
flows	dòng chảy
fluent	thông thạo
fluid	chất lỏng
flung	đã ném
flush	tuôn ra
fluttered	rung rinh
fly	bay
flying	đang bay
foal	con ngựa con
foam	bọt
foaming	đang tạo bọt
focal	thuộc tiêu điểm
focal point	tiêu điểm
focus	tập trung
foe	kẻ thù
fog	sương mù
fold	gấp
folds	nếp gấp
follow	theo
followed	đã đi theo
following	đang đi theo
folly	dại dột
fond	thích
fondle	vuốt ve
font	phông chữ
food	thực phẩm
fool	đánh lừa, thằng hề
fooled	đã (bị) lừa
fools	fools
foot	chân
football	bóng đá
foot-gear	đồ phụ tùng mặc cho chân
footing	thế đứng
footsore	đau chân
footsteps	những bước chân
for	cho
forbear	tổ tiên
forbid	cấm
forbiddingly	một cách cấm tuyệt
force	lực lượng
forced	đã buộc
fore	trước
forebears	những tổ tiên
forecast	dự báo
forego	bỏ qua
forehead	trán
foremost	quan trọng nhất
forest	rừng
forevalued	đã có giá trị trước đây
forever	mãi mãi
forewent	đi trước
forged	giả mạo; rèn
forget	quên
forgetfulness	sự lãng trí
forgive	tha thứ
forgot	đã quên
forgotten	đã quên
forlorn	đau khổ, tuyệt vọng
form	(tạo)hình thức
formal	chính thức
formed	hình thành
former	cựu, trước đây
formidable	ghê gớm, đáng ngại
forming	hình thành
forms	(tạo)(những) hình thức
forth	tới trước
fortune	tài sản
fortune teller	thầy bói
fortunes	vận may
forty	40
forty-mile	40 dặm
forward	về phía trước
fossil	hóa thạch
fought	đã chiến đấu
foul	hôi
found	đã tìm thấy
founder	người sáng lập
fountain	đài phun nước
fountains	đài phun nước
four	4
fourteen	14
fourth	thứ tư
fox	con cáo
fraction	phân số
fracture	sự gãy
fragile	dễ vỡ
frame	khung
frank	thẳng thắn
frankly	thẳng thắn
frantically	điên cuồng, hớt hãi
fraternity	phường hội
fraud	gian lận
fraught	đầy
free	miễn phí
freedom	tự do
freeze	đóng băng
freezing	đông lạnh
freight	vận tải hàng hóa
freighted	đã chuyên chở
french-canadian	Pháp-Canada
frenzy	giận điên lên, như điên
frequency	tần số
frequent	thường xuyên
frequently	một cách thường xuyên
fresh	tươi
fresher	mới hơn
fresh-written	mới viết
friction	ma sát
Friday	Thứ Sáu
friendliness	thân thiện
friendly	một cách thân thiện
friends	bạn bè
friendship	tình bạn
frighten	hoảng sợ
frightened	sợ hải
frightful	ghê sợ
frightfully	một cách kinh khủng
fringed	đã tua
frog	con ếch
from	từ
front	trước
frost	sương giá
frosty	lạnh giá
frothing	đang sùi bọt
frown	cau mày
frowning	đang cau mày
froze	đóng băng
frozen	đã đông lạnh
fruit	trái cây
frustrated	thất vọng, bực bội
fry	rán
fuel	nhiên liệu
fulfill	hoàn thành
full	đầy đủ
full-grown	lớn trưởng thành
fully	một cách đầy đủ
fume	cơn giận
fun	vui vẻ
function	chức năng
fund	quỹ tài chánh
fundamental	cơ bản
funeral	đám tang
fungus-covered	nấm phủ
funnel	cái phễu
funny	khôi hài, hài hước
fur	lông thú
furious	giận dữ
furiously	một cách giận dữ
furnished	đã trang trí nội thất
furniture	đồ nội thất
furred	phủ lông (thú); mọc lông
furry	nhiều lông lá
further	xa hơn
furthermore	hơn nữa
fury	cơn giận dử
fuss	lộn xộn
futile	vụn vặt
futilely	một cách vô ích
future	tương lai
gain	đạt được
gained	đã đạt được
gaining	đang đạt được
galvanized	mạ kẽm
gamble	đánh bạc
gamblers	con bạc
gambling	đang cờ bạc
game	trò chơi
gamekeepers	người bảo vệ thú (bị săn bắn)
games	trò chơi
gang	băng đảng
gangster	găng-xtơ
gap	khoảng cách
gape	sự há hốc miệng
gaping	đang há hốc miệng
garbage	rác
garbs	y phục
garden	vườn
gardener	người làm vườn
gardeners	những người làm vườn
gardener's	của người làm vườn
garlic	tỏi
garments	những đồ may mặc
gas	khí
gas station	trạm xăng
gashing	vết cắt sâu
gasp	giật nẩy lên
gasped	thở hổn hển
gasping	đang thở hổn hển lấy hơi
gather	tập hợp
gathered	đã thu thập
gaunt	gầy
gave	cho
gayety	vui nhộn
gaze	nhìn đăm đăm
gear	bánh răng
gee-pole	bánh lái xe chó
general	chung
generate	tạo ra
generation	thế hệ
generations	những thế hệ
generous	hào phóng, rộng lượng
generously	một cách hào phóng
genial	vui tánh
genius	thiên tài
gentle	nhẹ nhàng
gentleman	quý ông
gentlemen	quý ông
gentlenesses	sự nhẹ nhàng, dịu dàng
gentler	nhẹ nhàng hơn
genuine	thật
geological	địa chất
germ	vi trùng
gesture	cử chỉ
get	nhận được
getting	đang nhận được
ghost	ma
ghostly	một cách ma quái
giant	khổng lồ
giants	người khổng lồ
gift	quà tặng
gigantic	khổng lồ
ginger	gừng
gingerly	mọt cách cẩn thận
ginseng	nhân sâm
girl	cô gái
give	cho
given	đã (được) cho
giving	đang cho
glacier	sông băng
glaciers	những tảng băng
glad	vui mừng
gladdened	đã vui mừng
gladness	sự vui vẻ
glamour	say mê
glance	liếc qua
glanced	liếc nhìn
glare	nhìn chằm chằm
glass	ly
glasses	kính
glaze	men
glazed	bén lửa
gleaming	đang lấp lánh
gleefully	một cách hân hoan
glide	sự trượt, lướt
gliding	sự trượt
glimmering	tiêu tan
glimpses	những cái nhìn thoáng qua
glitter	long lanh, lấp lánh
global	toàn cầu
globe	thế giới
gloom	u ám
gloomy	ảm đạm
glorious	vẻ vang
gloriously	hoành tráng, huy hoàng
glory	vinh quang
gloss	cái bóng nhoáng bên ngoài
gloves	găng tay
glow	phát sáng
glowed	đã tỏa sáng
glue	keo
gnats	muỗi
gnaw	gặm
go	đi
go back	trở lại
goaded	đã kích
god	thần
godfather	cha đỡ đầu
goes	đi
going	đang đi
gold	vàng
golden	vàng
goldfish	cá vàng
goldseekers	những kẻ tìm vàng
gone	đã đi
good	tốt
Good bye	lời chào tạm biệt
Goodbye	tạm biệt
good-natured	dể chịu
good-naturedly	tốt
goods	hàng hóa
goose	ngỗng
gorge	hẻm núi
got	được
govern	cai trị
government	chính phủ
grace	tô điểm
gracious	thanh tao
grade	tầng lớp
grades	điểm
graduate	tốt nghiệp
graduation	tốt nghiệp
grain	hạt
grammar	ngữ pháp
grandfather	ông
grandmother	bà
grandsons	những cháu (nội/ngoại) trai
grant	ban cho
granule	hột nhỏ
grape	nho
grappled	đã vật lộn
grappling	vật lộn
grasp	nắm bắt
grass	cỏ
grasses	cỏ
gratifying	hài lòng
grating	ghê tai
gratitude	lòng biết ơn
grave	nghiêm trọng
gravel	sỏi
gravelled	được trải sỏi
gravely	một cách nghiêm trọng
gravity	lực hấp dẫn
gray	màu xám, xám xịt
grease	dầu mỡ
great	tuyệt vời
greater	lớn hơn
greatly	một cách to lớn
greatness	sự vĩ đại
green	xanh
greet	chào
greeting	chúc mừng
grew	đã lớn lên
grey	xám
grief	sự đau buồn
grievance	sự khiếu nại
grieve	đau buồn
grievously	một cách đau đớn
grim	nghiệt ngã
grimly	một cách ác ôn
grin	cười lộ răng
grind	xay
grinned	đã cười toe toét
grinning	cười toe toét
grip	nắm chặt
gripped	đã nắm chặt
grit	bụi bặm, bẩn
grittily	bụi bặm, bẩn
groan	rên rỉ
groaned	rên rỉ
groom	chú rể
grooms	chuẩn bị, những chú rể
grooves	rãnh
grope	mò mẫm
groping	đang mò mẫm
gross	tổng
ground	mặt đất
group	nhóm
grow	lớn lên
growers	người trồng
growing	đang mọc/phát triển
growl	gầm gừ
growled	đã gầm gừ
growling	đang gầm gừ
growls	gầm gừ
grown	đã phát triển
grown-up	trưởng thành
grows	phát triển
growth	tăng trưởng
grub	con sâu
grub-box	hộp thức ăn
grub-staked	đồ dự trữ
grudge	mối ác cảm
gruffly	thô lỗ
grumbled	đã càu nhàu
grumbling	càu nhàu
grunted	đã càu nhàu
grunting	càu nhàu
guarantee	bảo lãnh
guard	bảo vệ
guarded	đã bảo vệ
guardianship	sự che chở
guards	những người bảo vệ
guess	đoán
guest	khách
guide	hướng dẫn
guided	hướng dẫn
guiding	đang hướng dẫn
guilt	tội lỗi
guilty	có tội
gull	chim hải âu
gulp	nuốt chửng
gulped	đã nuốt ực
gum	kẹo cao su
gun	súng
gust	cơn gió mạnh
habit	thói quen
habits	những thói quen
had	đã có
hail	hoan hô
hailed	đã ca ngợi
hair	lông, tóc
hairless	không có lông/tóc
hairy	nhiều lông
half	phân nửa
half-breed	nửa giống lai
half-coy	nửa rụt rè
half-dozen	nửa tá
half-friendly	nửa thân thiện
half-frozen	nửa đông lạnh
half-grown	nửa phát triển
half-reluctantly	nửa miễn cưỡng
half-savage	nửa hoang dã
half-sobs	những thổn thức
half-started	nửa bắt đầu
half-stunned	đã nửa choáng váng
halfway	nửa chừng
half-wolves	nửa sói
hall	hội trường
halt	ngăn chặn, ngừng lại
halted	tạm dừng
hammer	búa
hammered	rèn
hand	bàn tay
handful	số ít
handicap	tật nguyền
handicapped	khuyết tật
handkerchief	khăn tay
handle	xử lý
hands	những bàn tay
handshake	bắt tay
handsome	đẹp trai
handwriting	chữ viết tay
handy	tiện dụng
hang	treo
hanging	đang treo
hankering	sự khao khát
happen	xảy ra
happened	đã xảy ra
happening	xảy ra
happiness	hạnh phúc
happy	hạnh phúc
harbor	bến cảng
hard	cứng
hardened	bị chai/cứng
harder	khó khăn hơn
hardest	khó khăn nhất
hardly	một cách hầu như không
hard-packed	đóng gói chặt cứng
hare	thỏ rừng
harked	đã lắng tai nghe
harking	đang lắng tai nghe
harm	tác hại
harmony	sự hài hòa
harness	bộ yên cương (ngựa)
harnessed	đã đóng yên, được chế ngự
harnesses	những bộ yên cương (ngựa)
harnessing	đang đóng yên, được chế ngự
harness-up	đóng yên
harrying	phiền nhiễu, quấy rối
harsh	thô, xù xì
harvest	thu hoạch
has	có
haste	sự mau
hastened	đẩy nhanh
hatch	nở
hatchet	rìu nhỏ
hate	ghét
hated	đã ghét
hatred	đã hận thù
hats	mũ
hauled	đã lôi
hauling	đang vận chuyển, lôi kéo
haunches	đùi
haunted	ma ám
have	có
having	đang có
hawk	chim ưng
hay	cỏ khô
hazard	mối nguy
he	ông/nó/hắn/anh ấy
head	đầu
headache	đau đầu
headed	đứng đầu
heading	nhóm
headquarters	trụ sở chính
heads	đầu
head-waters	đầu nguồn
heal	hàn gắn
healed	chữa lành
health	sức khỏe
heaped	được chất đống
hear	nghe
heard	đã nghe
hearing	đang nghe
heart	tim
heartbreaking	đang đau lòng
heart-easy	dễ dàng trong lòng
hearts	những trái tim
heat	nhiệt
heaven	thiên đường
heavier	nặng
heavily	một cách nặng nề
heavy	nặng
hedge	hàng rào ngăn cách
hedged	ngăn cách, rào đón; không trả lời thẳng, tìm lời thoái thác
hedgehog	con nhím
heed	lưu ý
heel	gót chân
heels	những gót chân/giày
height	chiều cao
heir	người thừa kế
held	đã (bị)giữ, được tổ chức
hell	địa ngục
hello	xin chào
hells	những địa ngục
hell's	của địa ngục
help	giúp đỡ
helped	giúp
helper	người phụ giúp
helpers	những người giúp đỡ
helpful	hữu ích
helping	đang giúp đỡ
helpless	bất lực, không thể giúp
helplessly	bất đắc dĩ
helplessness	sự bất lực
hemisphere	bán cầu
hepatitis	viêm gan
her	cô ta
heralded	đã báo trước
herbivore	động vật ăn cỏ
herd	bầy, đàn
here	đây
heredity	thừa kế
heretic	người theo dị giáo
hero	anh hùng
heroic	anh hùng
herself	mình
he's	anh ấy
hesitate	ngần ngại
hey	ê
hi	này (gọi, chào)
hid	đã ẩn,giấu, trốn
hidden	đã ẩn,giấu, trốn
hide	ẩn,giấu, trốn
hides	ẩn náu
hiding	đang ẩn/trốn
hiding-place	chỗ trốn
high	cao
high fever	sốt cao
higher	cao hơn
highly	một cách cao
high-strung	căng thẳng cao độ
hight	chiều cao
high-walled	vách cao
highway	đường cao tốc
hike	đi lang thang
hill	đồi
him	anh ta/nó
himself	chính nó/anh ta/ông ấy
hind	sau, ở đằng sau
hinder	cản trở
hinge	bản lề
hint	gợi ý
hip	hông
hips	những cái hông
hire	thuê
his	của nó/anh ta/ông ấy
historic drama	bi kịch lịch sử
history	lịch sử
hit	đánh
hitch	xô
hitching	cái giật mạnh bất ngờ; đi nhờ xe
hitting	đang đánh
hoarse	khan giọng
hobby	sở thích
hoisted	đã kéo, treo lên
hold	cầm giữ
holding	giữ
holds	giữ
hole	lổ
holes	lỗ
holiday	kỳ nghỉ
hollow	ôm ốm
holy	thánh
home	nhà, quê hương
homemade	tự làm
homesick	nhớ nhà
hometown	quê hương
homework	bài tập về nhà
homicide	hành động giết người
honest	trung thực
honestly	một cách trung thực
honey	mật ong
honeycomb	hình rỗ tổ ong
honeymoon	tuần trăng mật
honked	bấm kèn
honor	vinh hạnh
honorable	có tính danh dự
honored	đã vinh danh
hoof	móng guốc
hoofs	móng, đá bằng móng, cuốc bộ
hook	cái móc
hoop	vành đai
hope	mong
hoped	hy vọng
hopeless	vô vọng
horizon	chân trời
horizontal	ngang
horn	còi
horns	sừng
horrible	khủng khiếp
horribly	một cách khủng khiếp
horror	sự kinh dị
horse	ngựa
horse racing	đua ngựa
horse-hide	da ngựa
horses	những con ngựa
hospital	bệnh viện
host	chủ nhà
hostage	con tin
hostile	thù địch
hot	cay, nóng
hotel	khách sạn
hound	chó săn
hour	giờ
hours	những giờ
house	nhà
house arrest	quản thúc tại gia
house-dog	chó nhà
household	hộ gia đình
housekeeper	người quản gia
housemaids	người ở
housewife	người nội trợ
how	làm sao
however	tuy nhiên
howl	tru
howled	đã tru
howling	đang tru
hug	ôm
huge	to lớn
hum	bay o o
human	con người
humans	những con người
humble	khiêm tốn
humid	ẩm ướt
humor	hài hước
hundred	100
hundreds	hàng trăm
hundredweight	tạ
hung	đã treo
hunger	cơn đói
hunger-madness	cơn đói điên rồ
hungry	đói
hunt	săn
hunted	săn bắn
hunter	thợ săn
hunters	thợ săn
hunting	đang/cuộc săn bắn
hunting-knife	dao thợ săn
hunts	săn lùng
hurled	đã ném
hurling	ném
hurricane	bao
hurried	đã gấp rút
hurriedly	vội vàng
hurry	nhanh, gấp gáp
hurt	đau
hurting	đang làm tổn thương
husband	chồng
husband's	của chồng
huskies	những chó Ét-ki-mô
husky	chó Ét-ki-mô
hustle	xô đẩy, chen lấn
hut	túp lều
hybrid	ghép
hydrant	vòi nước
hypertension	tăng huyết áp
hypocritical	đạo đức giả
hysteria	thần kinh loạn
I	tôi
ice	băng
idea	ý tưởng
ideal	lý tưởng
identical	giống nhau
identification	nhận dạng
idiom	thành ngữ
idiot	thằng ngốc
idle	nhàn rỗi
idol	thần tượng
idols	những thần tượng
if	nếu
ignite	đốt cháy
ignominiously	một cách nhục nhã, đê tiện
ignore	phớt lờ
ignored	đã bỏ qua, phớt lờ
ill	đau, bệnh
I'll	tôi sẽ
illegal	bất hợp pháp
ill-tamed	đã bị thuần hóa
illuminate	chiếu sáng
illumined	đã soi sáng
illustrate	minh họa
I'm	tôi đang
I'm sorry	Tôi xin lỗi
image	hình ảnh
imagination	sự tưởng tượng
imagine	tưởng tượng
imagined	đã tưởng tượng
imitate	theo gương
imitation	sự bắt chước
immediate	ngay lập tức
immediately	một cách ngay lập tức
immoral	vô đạo đức
immortal	bất tử
impact	đụng chạm, tác động
impartial	vô tư, vô thiên vị
impatience	thiếu nhẩn nại
impatient	thiếu kiên nhẫn
impeach	buộc tội
impeachment	sự buộc tội
impede	cản trở
impediment	trở ngại
impelled	thúc đẩy
impending	đang sắp xảy ra
imperative	bắt buộc, quan trọng
imperiously	hống hách; độc đoán
imploringly	kêu nài
import	nhập khẩu
important	quan trọng
importuned	quấy rầy, nhũng nhiễu; đòi dai, nài nỉ
impossible	không thể
impress	gây ấn tượng
impression	ấn tượng
imprisoned	đã bị cầm tù
improper	không đúng
improve	cải thiện
improvise	chơi nhạc
impulse	sự bốc đồng, sự thúc đẩy
impulses	sự bốc đồng, sự thúc đẩy
in	trong
in order	để được
in the end	cuối cùng
inability	không có khả năng
inarticulate	không nói rõ ràng được, ú ớ
inauguration	khánh thành
incarnate	hiện thân
incarnation	sự hóa thân
inch	inxơ 2,54 cen ti mét
inches	những inxơ (Anh)
incident	chuyện ngẩu nhiên
incidentally	tình cờ
incline	dốc
inclined	đã nghiêng, thiên về
included	đã bao gồm
including	bao gồm cả
incoherent	không liên tục, không liền lạc
income	thu nhập
incompetence	không đủ sức, không đủ khả năng
incomprehensible	không thể hiểu được
inconceivably	không thể tưởng tượng
increase	tăng
increased	đã tăng
incurious	không hiếu kỳ
indeed	đã thực sự
indefinite	không xác định
independent	độc lập
indeterminate	lưỡng lự
index	chỉ số
index finger	ngón tay trỏ
India	Ấn Độ
indian	thổ dân
indicate	chỉ ra
indifferent	thờ ơ
indigestible	không tiêu
indirect	gián tiếp
indiscreet	không cẩn thận
indiscretion	sự không suy nghi
indispensable	không thể thiếu
individual	cá nhân
indoor	trong nhà
industry	ngành công nghiệp
inevitable	không thể tránh khỏi
inevitably	một cách chắc chắn
inexorable	không cảm động
inexperience	thiếu kinh nghiệm
infant	trẻ sơ sinh
infect	lây nhiễm
infinite	vô hạn
infinitely	một cách vô hạn
infinitesimal	cực nhỏ
inflammation	viêm
inflate	bơm phồng
inflation	lạm phát
influence	ảnh hưởng
inform	thông báo
information	thông tin
infrequent	ít xảy ra
inherit	thừa kế
inheritance	thừa kế
inherited	thừa kế
initial	ban đầu
injure	làm bị thương
injured	đã bị thương
inkling	một tí nào, một chút gì
innocent	ngây thơ
innocuously	kín đáo
innutritious	không có dinh dưỡng
inoffensive	không làm hại
insect	côn trùng
insensible	không cảm động
inseparable	không thể tách rời
insert	chèn
inside	trong
insides	bên trong
insidious	xảo quyệt
insist	nhấn mạnh, buộc
insisted	khẳng định, buộc
inspect	thanh tra
inspire	truyền cảm hứng
install	cài đặt
instance	trường hợp
instances	trường hợp
instant	trong khoảnh khắc đó, ngay lập tức
instantaneous	tức thời
instead	thay vì
instinct	bản năng
instinctively	một cách tự nhiên
instincts	những bản năng
instruction	sự hướng dẫn
instrument	dụng cụ
insubordination	tánh ngổ nghịch
insular	thiển cận
insulation	cách nhiệt
insult	xúc phạm
insurance	bảo hiểm
insure	đảm bảo
intelligence	trí thông minh
intend	định
intended	dự định
intense	cường độ cao, căng thẳng
intensely	mạnh mẽ, căng thẳng
intent	chủ ý
intention	ý định
intentions	những ý định
intentness	sự chăm chú cố ý
intercept	đánh chặn
interest	quan tâm, lãi
interested	quan tâm
interfere	can thiệp
interfered	đã can thiệp
interlacing	xen kẽ
internal	nội bộ
international	quốc tế
interpret	giải thích
interrupt	gián đoạn
interval	khoảng thời gian
intervals	khoảng thời gian
intimacy	sự thân mật
intimate	thân mật
intimated	gợi ý một cách thân mật
into	vào trong
intolerable	không chịu được
introduction	lời giới thiệu
introspective	nội tâm
invade	xâm lược
invaded	xâm lược
invaders	kẻ xâm lược
invent	phát minh
invention	phát minh
inventor	nhà phát minh
inventory	hàng tồn kho
invested	đã đầu tư
investigate	điều tra
invincible	bất khả chiến bại
invitations	những lời mời
invite	mời
involuntarily	một cách miễn cưỡng
involve	bao gồm
inward	vào bên trong
iron	ủi, sắt
irregular	không đều
irresistible	không thể cưỡng lại
irresolutely	nghi ngờ, phân vân
irritability	khó chịu
irritable	cáu kỉnh
irritate	kích thích
irritating	khó chịu
is	là
island	đảo
isolate	cách ly
issued	ban hành
it	nó
itch	ngứa
it'll	nó sẽ
its	của nó
it's	nó là
itself	chính nó
i've	Tôi đã
jaded	rủ rượi
jagged	có răng cưa
jail	tù
jam	mứt; chèn vào
jangling	đang réo inh ỏi
January	Tháng một
Japan	Nhật Bản
japanese	Nhật Bản
jar	lọ, bình, vại
jarring	nghịch tai
jaw	hàm
jaws	những cái hàm răng
jealous	ghen tuông
jealousy	ghen tuông
jerk	giật
jerked	đã giật
jerks	giật
jingling	đang leng keng
job	việc
jog	chạy bộ
join	tham gia
joined	đã tham gia
joint	chung
joke	trò đùa
jolted	rợn
journal	tạp chí
journey	hành trình
journeyers	những kẻ lang bạt
joy	niềm vui
joyful	hân hoan
joyfully	một cách hân hoan
jubilant	hân hoan
judge	thẩm phán
judges	phán xét
judgment	án
jugular	cuốn họng
juice	nước ép
juices	các nước trái cây
July	Tháng bảy
jump	nhảy
junction	mối nối
June	Tháng sáu
junior	trẻ
jury	bồi thẩm đoàn
just	chỉ, mới
justice	công lý, lẽ phải
jutted	thò
juvenile	vị thành niên
keel	sống thuyền
keen	quan tâm
keenest	sắc bén nhất
keenly	một cách cảnh giác
keep	giữ
keeping	đang giữ
kennel	chuồng
kennels	những cái chuồng
kept	đã giữ
kettle	bình đun nước
key	chìa khóa
keyed	dùng chìa khoá; thuộc trọng tâm
kick	đá
kid	đứa trẻ
kidnap	bắt cóc
kidnapped	đã (bị) bắt cóc
kidnapper	người bắt cóc
kidney	thận
kill	giết
killed	đã giết
killer	kẻ giết người
killing	giết chết
kin	thân nhân
kind	loại, hiền từ
kind-hearted	hảo tâm
kindliness	sự hiền từ
kindly	vui lòng, hiền từ
kindred	quan hệ thân tộc
kinds	các loại
king	vua
kingdom	vương quốc
kiss	hôn
kit	trang bị cần thiết cho một hoạt động, một công việc
kitchen	nhà bếp
kite	diều
kitten	mèo con
kittens	mèo con
klondike	làm lạnh đông cá
knee	đầu gối
kneel	quỳ gối
knees	các đầu gối
knelt	đã quỳ
knew	đã biết
knife	dao
knight	hiệp sĩ
knit	đan
knitted	dệt kim
knock	gõ
knocked	đã (bị) gõ
knocking	gõ
knot	nút thắt
knotting	thắt nút
knotty	như thắt chặt
know	biết
knowledge	kiến thức
known	đã (được) biết đến
knuckled	đốt ngón tay
knuckles	đốt ngón tay
Korea	Hàn Quốc
Korean	người Hàn Quốc
labor	lao động
laboratory	phòng thí nghiệm
lacerated	đã đau đớn
lack	thiếu
ladder	thang
lady	quý bà
laid	đã đặt
lake	ao hồ
lakes	những ao hồ
lamb	thịt cừu
lame	không thỏa đáng
land	đất
landed	đã hạ cánh
landing	đích
landlord	chủ nhà
landmark	mốc
landscape	cảnh quan
lane	làn đường
language	ngôn ngữ
lap	đùi
lapping	che qua, gấp qua
lapsed	đã trôi qua
large	to
largeness	sự rộng lớn
larger	lớn hơn
largest	lớn nhất
lash	dây da roi
lashing	đang roi vọt
lashings	những roi vọt
last	cuối cùng
late	khuya
late summer	Cuối mùa hè
latent	tiềm ẩn
later	sau
latest	mới nhất, trể nhất
latitude	vĩ độ
laugh	cười
laugh at	cười
laughed	đã cười
laughing	đang cười
launched	đã đưa ra
laundry	giặt ủi
law	pháp luật
lawgiver	nhà lập pháp
lawn	cỏ
lawns	những bãi cỏ
lawyer	luật sư
lay	đặt, nằm
lay off	đuổi việc
lay out	đặt ra
lays	đẻ; nằm
lazily	lười biếng
lazy	lười biếng
lead	dẫn đầu
lead-dog	chó dẫn đầu
leaden	như chì
leader	nhà lãnh đạo, thủ lĩnh
leaders	nhà lãnh đạo
leadership	sự lãnh đạo
leading	đang dẫn đầu
leaf	lá
leak	rò rỉ
lean	nạc, không dính mỡ
leap	nhảy qua
leaped	đã nhảy
leaping	đang nhảy qua
leapings	phóng
learn	học
learned	đã học
learning	đang học tập
lease	cho thuê
leash	dây buộc
leashed	đã buộc dây 
least	ít nhất
leather	da
leathery	giống như da
leave	để lại
leaves	lá
leaving	để lại, bỏ đi
lecture	bài giảng
led	đã dẫn
ledge	vành lồi ra
leech	con đỉa
leeward	dưới gió
left	đã rời bỏ, còn lại
leg	chân
legal	pháp lý
legend	huyền thoại
legion	nhiều, vô số, đoàn, lũ
legs	các chân
lend	cho vay
length	chiều dài
less	ít hơn
lessen	giảm bớt
lesser	thấp hơn
lesson	bài học
lessoned	bài học được 
let	hãy cho, để
lethal	gây chết người
letter	thư
letters	thư
letting	đang cho phép
lettuce	rau diếp
level	cấp
levels	mức độ
liability	trách nhiệm
liable	chịu trách nhiệm
liberal	tự do
liberty	tự do
library	thư viện
license	giấy phép
lick	liếm
licked	đã liếm
licking	đang liếm
lid	nắp
lie	nói dối
life	cuộc sống
life-and-death	cuộc sống và cái chết
lifeless	vô hồn
life's	của cuộc sống
lifetime	cả cuộc đời
lift	thang máy
lifted	đã (được) khiêng lên, dỡ bỏ
lifting	đang nâng
light	ánh sáng
light house	ngọn hải đăng
light refreshment	tĩnh dưỡng nhẹ nhàng
lightened	sáng sủa hơn, nhẹ hơn
lightening	làm sáng
lighter	nhẹ hơn
lighting	chiếu sáng, đèn
lightish-colored	màu sáng nhạt
lightly	một cách nhẹ nhảng
lightning-like	như chớp sét
lights	những đèn/ánh sáng
like	như, thích
likely	một cách có khả năng
likewise	cũng như vậy
lily	hoa loa kèn
limb	chân tay
limit	giới hạn
limitless	không giới hạn
limp	đi khập khiễng
limped	đã đi khập khiễng
limping	khập khểnh
limply	một cách yếu ớt, cà nhắc
line	dòng
linger	day dưa
lingered	nán lại
lingering	đang day dưa
lining	lót
link	liên kết
linked	liên kết, nối
lion	sư tử
lionlike	như sư tử
lip	môi
lips	những cái môi
liquid	lỏng
listen	nghe
listened	lắng nghe
listening	nghe
lit	thắp sáng
literally	một cách nghĩa đen
literature	văn học
little	ít
little finger	ngón tay út
live	sống
lived	đã sống
lively	sinh động
liver	gan
lives	(những) cuộc sống
living	đang sống
load	tải
loaded	đã nạp
loaf	sự đi chơi rong; sự lười nhác
loafing	đang lười nhác
loan	sự vay mượng
loath	ghét
loathsome	không ưa
lobby	vận động hành lang
local	địa phương
locate	xác định vị trí
lock	khóa
locomotive	di động
locomotives	đầu máy xe lửa
locust	châu chấu
lodge	nhà nghỉ
log	khúc gỗ mới đốn
logical	hợp lý
logs	những khúc gỗ mới đốn
lolling	đang thè lưỡi
lonely	một cách cô đơn
long	lâu/dài
long-barrelled	nòng dài 
long-desired	mong muốn lâu nay
long-drawn	kéo dài
longer	lâu/dài hơn
long-expected	mong đợi lâu nay
long-furred	phủ lông dài
look	xem
looked	đã nhìn
looking	đang thấy/nhìn
loom	bóng lờ mờ, hiện ra (với vẻ đe doạ)
loose	lỏng lẻo
loosed	lơi lỏng
loosely	một cách lỏng lẻo
loosen	lỏng ra
looted	bị cướp phá
lope	nhảy
loped	nhảy
lord	chủ
lose	thua
loser	kẻ bại, bên thua
loss	thiệt hại, mất mát
losses	thiệt hại, mất mát
lost	thua
lot	lô
lottery	xổ số
louder	to hơn
loudly	một cách to
love	yêu
loved	đã yêu
lovely	đáng yêu
lovingly	yêu thương, trìu mến
low	thấp
lower	giảm, thấp hơn
lowered	giảm
loyal	trung thành
luck	may mắn
luggage	hành lý
lugged	lôi theo
lugubriously	sầu thảm, bi thảm
lunch	bữa ăn trưa
lung	phổi
lunge	cú nhào tới
lurched	lảo đảo
lure	thu hút
lures	dụ, hút
luring	thu hút
luringly	thu hút
lurking	ẩn núp
lust	ham muốn
lusty	cường tráng, mạnh mẽ, đầy khí lực, đầy sức sống
luxurious	sang trọng
lying	nằm; nói láo
lyrics	Lời bài hát
machine	máy
machine-like	như máy
mackerel	cá thu
mad	điên
made	đã làm/thực hiện
madly	một cách điên cuồng
madness	sự điên rồ
magic	ảo thuật
magnet	nam châm
magnetic	từ trường, nam châm
magnetism	từ trường, nam châm
magnificent	lộng lẫy, tráng lệ
magnify	phóng to
magpie	chích chòe
maid	người giúp việc
mail	thư
mailbox	hộp thư
mailman	người đưa thư
mail-train	xe lữa đưa thư
main	chính
maintain	duy trì
maintaining	duy trì
major	chính
majority	đa số
majority rule	luật đa số
make	làm
makes	làm
makeup	trang điểm
making	đang làm
male	nam
malice	ác tâm
malicious	độc hại
malignant	ác tính
malinger	làm bộ đau
malingerer	người giả ốm để trốn việc
mall	trung tâm
mammal	động vật có vú
man	người đàn ông
man power	nhân công, nhân sự
manage	quản lý
managed	đã quản lý
manager	quản lý
mandate	nhiệm vụ
mane	lông gáy
maneuver	điều động
mangled	cắn xé
manhood	nhân cách
mania	chứng điên loạn
maniac	người điên
manifested	biểu hiện
manifestly	hiển nhiên
mankind	nhân loại
manner	phong cách
manoeuvre	thao diển, điều khiển
manoeuvred	đã thao diễn
manor	trang viên, nhà
manpower	nhân lực
man's	của con người
mansion	biệt thự
mantel	mặt lò sưởi
manual	bằng tay
manufacture	sản xuất
many	nhiều
many-noted	nhiều ghi nhận
map	bản đồ
marauders	những kẻ cướp
marble	đá cẩm thạch
March	Tháng ba
marched	đã diễn hành
marching	sự diển hành
margin	lợi nhuận, lãi suất
marine	biển
mark	tiêu chuẩn
marked	đã đánh dấu
market	thị trường
marks	(đánh) dấu
married couple	cặp vợ chồng kết hôn
marrow	tủy
marry	kết hôn
marsh	đầm lầy
marvellous	kỳ diệu
mash	đầm lầy
mass	khối lượng
massive	lớn
master	chủ
mastered	đã làm chủ
masterful	thích sai khiến, siêu việt
masters	chủ nhân; bậc thầy
master's	của chủ nhân; của bậc thầy
mastery	thống trị, bá chủ, sự tinh thông
match	làm cho phù hợp
matching	đang phù hợp
mate	bạn, bạn nghề
material	vật liệu
maternal	(thuộc) mẹ
maternity	thai sản
mates	những đồng bạn
mathematic	(thuộc) toán học
mathematics	toán học
matted	đã (được) bện
matter	vấn đề
matters	vấn đề
mature	trưởng thành
maximum	tối đa
may	có thể
mayor	thị trưởng
me	tôi
meadow	bải cỏ
meal	bữa ăn
meal-time	thời gian bữa ăn
mean	có nghĩa là
meaning	đang có nghĩa là
means	có nghĩa là
meant	có ý/nghĩa là
meantime	khi đó
measure	đo
measured	đo
meat	thịt
meatball	thịt viên
mechanical	(thuộc) về cơ khí
medal	huy chương
meddle	can thiệp
median	ở giữa
medic	lính cứu thương
medical	y tế, y học
medication	thuốc
medicine	y học
meditate	thiền
meditated	đã thiền định
medium	trung bình
meekly	ngoan ngoãn
meet	đáp ứng
meeting	đang họp, cuộc họp
melancholy	u sầu
mellow	êm dịu
melody	giai điệu
melt	tan chảy
member	thành viên
memorable	đáng nhớ
memories	những kỷ niệm
memorize	ghi nhớ
memory	trí nhớ
men	người đàn ông
menace	hăm dọa
menacing	đe dọa
menacingly	một cách đe dọa
mend	sửa sang
mending	sự sửa chửa
mental	tâm thần
mentally	một cách tinh thần
mention	đề cập đến
merchandise	hàng hóa
merciful	nhân từ
merciless	tàn nhẫn
mercilessly	một cách không thương tiếc
mercy	lòng thương xót
mere	chỉ
merely	chỉ
merge	hợp nhất
merit	công lao
mermaid	người cá
merrily	vui vẻ
mess	lộn xộn
message	tin nhắn
messenger	sứ giả, người đưa tin
messengers	sứ giả
met	đã gặp
metal	kim loại
metallic	kim loại
metamorphosed	biến chất
method	phương pháp
metropolis	đô thị
Mexican	thuôộc Mễ Tây Cơ
microscope	kính hiển vi
mid	giữa
midday	trưa
middle	ở giữa
middle age	tuổi trung niên
middle aged man	người đàn ông trung niên
middle aged woman	người phụ nữ trung niên
middle finger	ngón giữa
middle-aged	đứng tuổi
midmost	ở ngay chính giữa
midnight	nửa đêm
midnights	nửa đêm
midst	giữa
midway	giữa đường
might	có thể
mightily	một cách mạnh mẽ
mighty	hùng vĩ
migrating	di cư
mild	nhẹ
mild fever	sốt nhẹ
mile	dặm
miles	nhiều dặm
military	quân sự, quân đội
milk	sữa
mill	nhà máy
million	triệu
mill-race	cuộc đua nhà máy
mimic	bắt chước
mince	băm, thái
mind	(quan) tâm
mine	của tôi
miner	thợ mỏ
mineral	khoáng sản
miners	thợ mỏ
miners'	của thợ mỏ
mines	các mỏ
mineself	của tôi
mingle	lẫn vào
minimum	tối thiểu
mining	khai thác khoáng sản
ministrations	sự cứu giúp, sự giúp đỡ, sự chăm sóc
minor	nhỏ
minority	thiểu số
minute	phút
minutes	những phút
miracle	phép lạ
misbelieve	không tin
miscalculated	tính nhầm
mischief	mối nguy hại
misdeed	việc làm có hại
misdemeanors	những tội nhẹ
miserable	khổ sở
misery	đau khổ
misplace	đặt nhầm
miss	bỏ lỡ
missed	đã bỏ lỡ
missile	tên lửa
missing	đang mất tích
mission	nhiệm vụ
missionary	người truyền giáo
mist	sương mù
mistake	sai lầm
mistaken	nhầm lẫn
mistakes	những sai lầm
misunderstand	hiểu nhầm
misunderstandings	hiểu lầm
misunderstood	hiểu lầm
mite	vật nhỏ bé, một chút; con ve, con rệp
mitten	găng tay hở ngón
mittened	được mang găng tay
mittens	găng tay
mix	pha
moan	kêu van
moaned	đã than van, kêu van, rền rĩ
mobile	di động
moccasins	những giày da
mock	giả
mode	chế độ, mốt
moderate	vừa phải
modern	hiện đại
modernize	hiện đại hóa
modest	khiêm tốn
moist	ẩm
moisture	độ ẩm
mole	nốt ruồi
molest	sàm sỡ
mom	mẹ
moment	thời điểm
moments	khoảnh khắc
moment's	của thời điểm
momentum	đà
Monday	Thứ hai
money	tiền
mongrels	loài hỗn hợp
monkey	khỉ
monopoly	độc quyền
monosyllabic	đơn âm
monotonous	đều đều, đơn điệu, buồn tẻ
monster	quái vật
monthly	hàng tháng
months	tháng
monument	tượng đài
mood	tâm trạng
moods	những tâm trạng
moon	mặt trăng
moon-flooded	đã mặt trăng tràn ngập
moonlight	sáng trăng
moonshine	ánh trăng
moose	một loại nai lớn sừng tấm
moose-hide	da nai sừng tấm
mops	giẻ lau sàn
moral	đạo đức
more	hơn
moreover	hơn thế nữa
morning	buổi sáng
morning sickness	ốm nghén
morose	u buồn
mortal	chết, tử
mortgage	vay thế chấp
mosquito	muỗi
mosquitoes	muỗi
moss	rêu
most	nhất
moth	bướm đêm
mother	mẹ
mother in law	mẹ chồng (mẹ vợ)
mothers	các bà mẹ
mother's	của mẹ
motion	chuyển động
motionless	bất động
motive	động cơ
mould	khuôn
mount	trèo
mountain	núi
mountainous	miền núi
mountains	núi
mourn	thương tiếc
mournful	bi ai
mournfully	kêu thảm thiết
mourning	tang khóc, đang sầu bi ai mất
mouse	chuột
mouth	miệng
move	di chuyển
moved	đã chuyển dời
movement	phong trào
movements	chuyển động; phong trào
movie	phim
moving	di chuyển
much	nhiều
muck	đồ bẩn thỉu, rác rưởi; đồ ô uế
mud	bùn
muddy	bùn
mug	cốc
mule	con la
multiplied	nhân lên
multiply	nhân
multitudinous	đủ thứ
mumble	lẩm bẩm
mummy	Xác ướp
municipal	thành phố
murder	giết người
murmur	tiếng rì rầm
murmured	thì thầm
murmurs	thì thầm
muscle	cơ bắp
muscles	những cơ bắp
muse	trầm ngâm
muses	suy tư, ngẫm nghĩ
museum	bảo tàng
mush	lái xe chó
mushers	những kẻ lái xe chó
mushroom	nấm
mushy	xốp
music	âm nhạc
musical	âm nhạc
musician	nhạc sĩ
musing	suy tư, mơ màng
must	phải
mustache	ria
mustard	mù tạt
mustn't	không cần, phải không
mutation	đột biến
mute	thầm lặng
mutiny	nổi loạn
mutter	sự lẩm bẩm
muzzle	bịt
my	của tôi
myself	tự bản thân
mysterious	bí ẩn
mysteriously	bí ẩn
mystery	bí ẩn
myth	thần thoại
nag	ngựa con
nagging	đang hay cải nhau
nail	cái đinh
naked	đã trần truồng
name	tên
name card	thẻ tên
name plate	tấm biển tên
nameless	vô danh
names	tên
nap	ngủ trưa
nape	gáy
narcotic	ma tuý
narrate	kể lại
narrow	hẹp
narrow minded man	người đàn ông hẹp hòi
narwhal	độc giác ngư
nasal	mũi
nasty	khó chịu
natal	sinh đẻ
nation	quốc gia
nationality	quốc tịch
native	bản địa
natural	thiên nhiên
nature	thiên nhiên
navy	hải quân
near	gần
neared	đến gần
nearer	gần hơn
nearly	gần
nearsighted	cận thị
neat	gọn gàng
necessaries	những thứ cần thiết
necessarily	một cách nhất thiết phải
necessary	cần thiết
neck	cổ
neck-hair	cổ tóc
necklace	vòng cổ
need	đã cần
needed	cần thiết
needle	nhu cầu
needs	những nhu cầu
negate	phủ nhận
negative	tiêu cực
neglect	bỏ bê
negotiate	đàm phán
neighbor	hàng xóm
neighboring	láng giềng
neither	không
nephew	cháu trai
nerve	thần kinh
nervous	hồi hộp, thần kinh
nest	tổ
nests	những cái tổ
net	mạng lưới
neutral	trung lập
never	không bao giờ
nevertheless	dù sao đi nữa
new	mới
newborn	trẻ sơ sinh
newcomers	những người mới đến
new-fallen	mới vừa rớt xuống
news	tin tức
newspaper	tờ báo
newspapers	những tờ báo
next	tiếp theo
nice	đẹp
Nice to meet you	rất vui được gặp bạn
nickname	biệt danh
niece	cháu gái
niggerheads	người da đen mạnh mẽ
night	đêm
night time	ban đêm
nightmare	cơn ác mộng
nights	những đêm
nimble	khéo léo
nine	9
nineteen	mười chín
ninety	chín mươi
ninth	thứ chín
nip	cái cấu, cái véo, cái cắn
nipped	đã cắn, cấu, véo
nipple	núm vú
nitrogen	khí nitơ
no	không
no charge	miễn phí
noble	cao thượng
noblest	cao quý
nobody	không ai
nocturnal	về đêm
nod	gật đầu
nodded	đã gật đầu
nodding	gật đầu
noise	tiếng ồn
noiselessly	yên lặng
noises	những tiếng ồn
noisy	ồn ào
nominal	danh nghĩa
nominate	đề cử
none	không ai/cái nào
nonprofit organization	tổ chức phi lợi nhuận
nonsense	vô nghĩa
noodle	mì
noon	trưa
nor	cũng không
normal	bình thường
north	phía bắc
northland	xứ ở miền bắc
northwest	phía tây bắc
nose	mũi
noses	mũi
nosing	đang sục sạo
nostrils	những lỗ mũi
not	không
notches	mức, khứa hình V
note	ghi chú
notebook	máy tính xách tay
noted	lưu ý
nothing	không có gì
notice	thông báo
noticing	đang nhận thấy
notify	thông báo
notorious	khét tiếng
noun	danh từ
nourish	nuôi
novel	tiểu thuyết
November	Tháng mười một
now	bây giờ
nowadays	ngày nay
nowhere	không nơi nào, không ở đâu
nude	hình khỏa thân, người khỏa thân
nudge	thúc bằng khuỷu tay
nuggets	cốm, cục nhỏ
null	không
numb	tê
number	số
numerous	nhiều
nurse	y tá
nursed	chăm sóc
nursery	nhà trẻ, trường mẫu giáo
nursing	điều dưỡng
nut	hạt
nutriment	chất ăn bổ; chất dinh dưỡng
nutrition	dinh dưỡng
oar	mái chèo
oath	tuyên thệ
oaths	những tuyên thệ
obdurate	cứng rắn, sắt đá, không lay chuyển
obedience	sự vâng lời
obedient	biết vâng lời
obediently	ngoan ngoãn
obey	tuân theo
obeyed	đã tuân theo
object	đồ vật
objective	mục tiêu
obligation	nghĩa vụ
obliterated	xóa sạch
oblong	hình chữ nhật
obscure	che đậy
obscurely	một cách che khuất, mờ đi
obscureness	tối, tối tăm, mờ mịt
observe	tuân theo
observed	đã quan sát
obtain	đạt được
obtained	thu được
obtuse	hạn hẹp
obvious	rõ ràng
occasion	dịp
occasional	thỉnh thoảng
occasions	những dịp
occupants	người cư ngụ
occupation	nghề nghiệp
occupied	đã chiếm
occupy	chiếm
occur	xảy ra
ocean	đại dương
October	Tháng Mười
octopus	bạch tuộc
odd	lẻ
odds	những phần thắng thua
odor	mùi
of	của
of course	tất nhiên
off	off
offence	hành vi phạm tội
offending	đang vi phạm
offense	hành vi phạm tội
offensive	tấn công
offer	cung cấp
offered	cung cấp, mời
offering	cung cấp, mời
office	văn phòng
officer	viên chức
official	chính thức
official residence	dinh thự chính thức
offspring	con đẻ
off-spring	con cái
off-the-record	bí mật
often	thường
oftener	thường hơn
oh	ô!
oil	dầu
ointment	thuốc mỡ
old	xưa
old bachelor	người độc thân già
old maid	gái già
older	cũ hơn, già hơn
oldest	lâu đời, già, lớn tuổi - nhất
old-fashioned	lạc hậu
old-time	thời gian cũ
omnivore	động vật ăn tạp
on	trên
once	một lần
one	một
one-eyed	một mắt
ones	những người/món/vật
one's	của một người
onion	hành
onlookers	những người xem
onlooking	đang xem
only	chỉ, duy nhất
onset	từ bắt đầu
open	mở ra
opened	đã mở ra
opening	đang mở
openly	một cách công khai
open-minded	phóng khoáng
operate	vận hành
operating	đang hoạt động
operation	hoạt động
opinion	ý kiến
opinions	ý kiến
opportunity	cơ hội
oppose	phản đối
opposing	đang đối lập
opposite	đối diện
oppressed	bị áp bức
optic	quang
optimism	lạc quan
optimistic	lạc quan
option	tùy chọn
or	hoặc
oral	bằng miệng
orange	màu da cam
orbit	quỹ đạo
orchard	vườn cây ăn quả
orchards	những vườn cây ăn trái
ordained	đã thụ phong linh mục
order	ra lệnh, đơn đặt hàng
orderly	trật tự
orders	ra lệnh, đơn đặt hàng
ordinary	bình thường
organ	cơ quan
organization	tổ chức
organizing	đang tổ chức
origin	nguồn gốc
original	nguyên thuỷ, từ dầu, y nguyên
orphan	trẻ mồ côi
orthodox	chánh giáo
ostrich	đà điểu
other	khác
others	những người khác
other's	của những người khác
otherwise	nếu không
ounce	aoxơ (28,35 gram)
our	của chúng tôi
out	ra
outa	(viết tắt) out of: ra khỏi
outbreak	bùng phát
outcome	hậu quả
outdistanced	bỏ xa, vượt xa
outdoor	ngoài trời
outer	bên ngoài
outfit	trang phục
outlaw	cấm
outline	phác thảo
outlined	nêu
outlines	phác thảo
outlook	triển vọng
outrage	sự phẫn nộ
outside	bên ngoài
outsides	bên ngoài
outspoken	thẳng thắn
outstanding	nổi bật
oval	hình bầu dục
ovation	sự hoan hô
over	vượt qua, hơn, trên
overcome	vượt qua
overeat	ăn quá nhiều
overestimate	đánh giá quá cao
overfeeding	ăn quá mức
overflow	tràn qua
overhanging	đang nhô ra bên trên
overhauled	đại tu
overhead	trên đầu
overhear	nghe lỏm
overheat	quá nóng
overlap	chồng chéo lên nhau
overloaded	quá tải
overlook	lờ đi
overlooked	bỏ qua, nhìn qua
overnight	qua đêm
overpass	vượt qua
overpower	chế ngự
overpowering	sự áp phục
overrunning	tràn ngập
overspilling	tràn ra
overtake	vượt quá
overtaken	vượt qua
overthrow	lật đổ
overthrowing	đang lật đổ
overthrown	đã lật đổ
overture	khởi sự
overturning	đảo lộn
overwhelm	tràn ngập
owe	nợ
owl	con cú
own	làm chủ, riêng tư
owners'	của chủ
oxygen	ôxy
oyster	sò
pace	tốc độ
pack	đóng gói, gói
packed	đã đóng gói
packing	đang đóng gói
packs	những gói
pads	miếng đệm
paid	thanh toán
pail	thùng
pain	đau
pain killer	thuốc giảm đau
painful	đau đớn
painfully	một cách đau đớn
pains	những cơn đau
painstakingly	tỉ mỉ, công phu
paint	sơn
painter	họa sĩ
pair	đôi
pajamas	bộ đồ ngủ
palace	cung điện
pale	nhạt, tái
paled	rào lại
pall	vải phủ quan tài, làm chán
palm	bàn tay
palmated	như bàn tay
palpitant	rung động, cảm nhận
pampered	đã nuông chiều
pandemonium	nơi hỗn loạn
pangs	những nổi giằn vặt, day dứt
panic	hoảng kinh
pans	chảo
pant	thở hổn hển
panther	con beo
panting	đang thở hổn hển
pants	quần
paper	giấy
paperwork	thủ tục giấy tờ
parade	duyệt binh
paradise	thiên đường
paradox	nghịch lý
parallel	song song
parasite	ký sinh trùng
parcels	phẩm, bưu kiện
parch	làm khô nẻ
parched	khô cằn
pare	gọt vỏ
parent	cha mẹ
park	công viên
parking lot	nơi đậu xe
paroxysms	nổ bùng, bộc phát bất ngờ
parrot	con vẹt
part	một phần
part-grown	phần phát triển
participate	tham gia
particle	hạt
particular	riêng biệt
particularly	một cách đặc biệt
partly	một phần
partner	đối tác
partners	đối tác
partnership	công ty, quan hệ đối tác hùng hạp
partridges	gà gô
parts	những bộ phận
party	tiệc
pass	qua
passage	đi qua
passanger	hành khách
passed	đã thông qua/đạt, đã đi qua
passes	qua
passing	đang đi qua
passion	niềm đam mê
passionate	đam mê
passive	thụ động, bị động
passiveness	sự thụ động
passport	hộ chiếu
past	qua
paste	dán
pastor	mục sư
pastry	bánh ngọt
pasture	đồng cỏ
pastures	những đồng cỏ
pat	vỗ nhẹ, vỗ về
patches	các mảnh vá
paternal	về đằng nội
path	con đường
pathetic	cảm động
patience	kiên nhẫn
patient	bệnh nhân
patriot	người yêu nước
patron	người bảo trợ
patted	đã vỗ nhẹ
pattern	mô hình
pause	tạm dừng
paused	dừng lại
pave	lát
pawn	quân tốt đen
paws	những bàn chân
pay	trả tiền
pay back	trả lại
pea	hạt đậu
peace	hòa bình
peach	đào
peacock	con công
peak	cao điểm
peaks	đỉnh
peanut	đậu phộng
pear	quả lê
pearl	ngọc trai
pebble	đá cuội
peck	mổ
peculiar	lạ lùng
peculiarity	sự lạ lùng
peculiarly	đặc biệt
pedestrian	người đi bộ
pediatrician	bác sĩ nhi khoa
peel	vỏ
peep	nhìn hé
peer	người cùng lứa
peered	đã nhìn chăm chú
pellets	những viên
pell-mell	lộn xộn
penal	hình sự
penalty	hình phạt
penance	ăn năn
pencil	bút chì
pending	chưa giải quyết
penetrate	xuyên qua
penetrated	thâm nhập
peninsula	bán đảo
penisular	dân ở bán đảo
pension	lương hưu
pent	bị đóng
pentition	kiến nghị
people	người dân
pepper	tiêu
pepper-boxes	đầy lổ, hộp tiêu
perambulating	đi xuyên qua (để xem xét)
perceived	nhận thức
perceiving	cảm nhận
percent	phần trăm
percentage	tỷ lệ phần trăm
percentile	phân vị
perceptibly	cảm nhận
perches	đậu
percussion	chuyển động
peremptorily	cưỡng bách, độc tài, độc đoán, dứt khoát, kiên quyết
perfect	hoàn hảo
perform	thực hiện
performance	diễn xuất
performed	thực hiện
perfume	hương thơm
perhaps	có lẽ
peril	nguy hiểm
period	giai đoạn
periods	những thời đoạn
perish	bỏ mạng
permanent	vĩnh viễn
permit	Giấy phép
permitted	được phép
permitting	cho phép
perpendicular	vuông góc
perpetual	không ngừng, luôn, suốt, vĩnh viễn
perplexed	lộn xộn
persist	kiên gan
persisted	tồn tại
persistent	khăng khăng
personal	riêng tư
perspective	khía cạnh
pertinacity	tánh bướng bỉnh
pervaded	đã xâm nhập
pervert	người hư hỏng
pessimistic	bi quan
pest	loài gây hại
pesticide	thuốc trừ sâu
pet	thú cưng
petal	cánh hoa
petition	kiến nghị
petrify	phong hóa
petted	vuốt ve
petty	nhỏ
pevert	xuyên tạc
phantom	ma
pharmacist	dược sĩ
pharmacy	dược
phase	giai đoạn
pheasant	chim trĩ
philosophy	triết học
phobia	nỗi sợ hãi
phoenix	phượng hoàng
photo	ảnh
photograph	chụp ảnh
phrase	cụm từ
physical	thể chất
physician	bác sĩ
physics	vật lý
pick	chọn
pick pocket	kẻ móc túi
picked	đã chọn
picking	chọn
pickpocket	kẻ móc túi
picnic	đi dã ngoại
picture	hình ảnh
piece	mảnh, miếng
pieces	những miếng
pier	bến tàu
pierce	đâm vào
pig	con lợn
pigeon	chim bồ câu
pigment	sắc tố
pike	cây giáo
pile	cọc
piled	xếp thành đống
pill	thuốc viên
pillar	trụ cột
pillow	gối
pilot	phi công
pinch	véo
pine	cây thông
pines	cây thông
pink	màu hồng
pipe	ống
pipes	ống
pirate	cướp biển
pistol-shot	tiếng súng lục
pit	hố
pitch	sân
pitched	đã pitched
pitcher	bình
pitiful	đáng thương
pity	đáng tiếc
pivot	trục đứng
pivoting	sự xoay
placatingly	một cách placatingly
place	nơi
placed	đã đặt
placer	chất khoáng trên đất cát
places	những nơi
plagiarism	sao chép
plain	đồng bằng, đơn giản
plainly	một cách ngay thẳng, bộc trực
plaint	đơn thưa kiện
plan	kế hoạch
plane	máy bay
plank	phiến gỗ
plant	cây
plaster	thạch cao
plate	đĩa
platform	bệ
play	chơi
played	đã chơi
player	người chơi
playfully	tinh nghịch
plays	đóng, chơi
plea	lời cầu xin
plead	nài xin
pleaded	đã nài xin
pleading	đang nài xin
pleasant	dễ chịu
please	làm ơn
pleased	hài lòng
pledge	cam kết
plenty	nhiều
plethoric	thặng dư
plight	hoàn cảnh khó khăn
plot	âm mưu
ploughed	đã cày
plow	cày
pluck	nhổ lông
plum	mận
plunge	lao vào
plunged	đã - giảm, lao vào, lao xuống
plunging	đang - giảm, lao vào, lao xuống
plural	số nhiều
plus	thêm
pneumonia	viêm phổi
pocket	túi
poem	bài thơ
poet	nhà thơ
point	điểm
pointed	đã chỉ
pointedly	thẳng thừng; chua cay
pointers	con trỏ
pointing	đang chỉ
pointless	vô nghĩa
points	điểm, trỏ
poise	sự cân bằng, lơ lửng
poised	đã sẵn sàng, dừng
poison	chất độc
poke	thọc
poked	đã chọc
polar	địa cực
pole	cực, cắm cột, chống bằng cột, (người Ba Lan)
poled	thuộc cột dựng đứng
police	cảnh sát, công an
policeman	cảnh sát
policy	chính sách
poling-boat	thuyền có cột đứng
polish	đánh bóng
polite	lịch sự
politeness	sự lể phép
political	chính trị
politician	chính trị gia
poll	thăm dò ý kiến
pollen	phấn hoa
pollutant	chất gây ô nhiễm
pollute	gây ô nhiễm
pompous	kiêu ngạo
pond	ao
ponder	suy ngẫm
pool	hồ bơi
pools	hồ bơi
poor	nghèo
poorer	nghèo hơn
poplars	những cây dương
popular	phổ biến
population	dân số
populous	đông dân
porcupine	con nhím
pork	thịt lợn
port	cảng
portable	di động
portal	cổng
porter	bia đen
portion	phần
portrait	chân dung
pose	đưa ra
position	vị trí
positive	tích cực
possess	có
possessed	đã sở hữu
possession	sự sở hữu
possibility	khả năng
possible	có thể
possiblity	khả năng
possibly	một cách có thể
post	đăng
post office	bưu điện
post war	sau chiến tranh
postcard	bưu thiếp
posterior	sau
posterity	con cháu
postpone	hoãn
postscript	tái bút
postulate	định đề
posture	tư thế
pot	bình
potato	khoai tây
potent	hiệu lực, mạnh
potential	tiềm năng
pottery	gốm
pouch	túi
pouch-strings	giây thắt túi
poultry	gia cầm
pounce	tấn công bất ngờ
pound	pao (450 gam), nện
pounded	đã - đập, nện
pounding	sự nghiền nát, sự nện đập
pounds	những pao
pour	rót, đổ
poured	đổ
poverty	nghèo đói
powder	bột
powdery	như bụi/bột
power	quyền lực
powerful	mạnh mẽ
powerfully	mạnh mẽ
powerless	bất lực
practical	thực tế
practically	thực tế
practice	thực hành
practised	đã tập luyện
prairie	đồng cỏ
praise	khen ngợi
prance	đi vênh váo
prank	trò đùa
pray	cầu nguyện
prayed	đã cầu nguyện
preach	giảng
preaching	rao giảng
preamble	lời nói đầu
prearrange	thu xếp trước, chuẩn bị trước
precede	đến trước
precept	châm ngôn
precession	sự tiến động
precinct	ranh giới
precious	quý giá
precipitate	làm - kết tủa, mau đến
precise	chính xác
preclude	loại trừ
predecessor	người tiền nhiệm
predicate	khẳng định
predict	dự đoán
preeminently	một cách - xuất sắc, ưu việt
prefer	thích
preferred	ưa thích
prefix	tiền tố
pregnant	mang thai
prejudice	thành kiến
prejudices	định kiến
preliminary	cơ bản
prelude	mở đầu
premature	sớm
premier	hàng đầu
premium	phí bảo hiểm
prepare	chuẩn bị
prepared	đã chuẩn bị
preparing	chuẩn bị
preposition	giới từ
prescribe	quy định
prescription	đơn thuốc
presence	hiện diện
present	trình bày
presenting	trình bày
presently	hiện nay
preserve	bảo quản
preserver	bảo quản
president	Chủ tịch
press	báo chí
pressed	đã ép
pressing	nhấn
pressure	áp lực
prestige	uy tín
presume	cho là
pretend	giả vờ
pretty	khá
prevent	ngăn chặn
prevented	ngăn chặn
preview	duyệt trước
previous	trước
prey	con mồi
preyed	mồi
preying	săn
price	giá cả
pricked	bị đâm
prickle	có cảm giác kim châm
pride	kiêu hãnh
prided	đã tự hào
priest	linh mục
primary	tiểu học
prime	quan trọng nhất
prime minister	Thủ tướng
primeval	thái cổ, nguyên thủy
primitive	ban sơ, thô sơ, cổ xưa
primordial	ban sơ
prince	hoàng tử
princess	công chúa
principal	chính
principally	chủ yếu
principle	nguyên tắc
print	chữ in
prints	in
prior	trước
priority	ưu tiên
prison	nhà tù
privacy	riêng tư
private	riêng tư
private life	cuộc sống riêng tư
private school	trường tư
privilege	đặc quyền
prize	giải thưởng
probability	xác suất
probation	tập sự
problem	vấn đề
proceed	tiến hành
proceeded	đã tiến hành
proceeding	tiến hành
proceeds	tiền thu được
process	quá trình
proclaim	công bố
proclaimed	công bố
proclaiming	công bố
prodded	thúc giục
produce	sản xuất
producer	sản xuất
professional	chuyên nghiệp
professor	Giáo sư
profit	lợi nhuận
profound	sâu
progeny	con cháu
program	chương trình
progress	(sự) tiến bộ
prohibit	cấm
project	dự án
projected	đã dự
prolong	kéo dài
prolonged	kéo dài
prominent	nổi bật
promise	lời hứa
promises	hứa hẹn
promote	thúc đẩy
prompt	đúng hẹn, nhanh nhẩu; nhắc nhở
prompting	thúc đẩy
promptly	một cách - kịp thời, nhanh chóng
prone	nghiêng về, dể bị
pronounce	phát âm
proof	bằng chứng
propel	đẩy
propelled	đã đẩy
propeller	cánh quạt
proper	riêng
property	tài sản
proportion	tỷ lệ
proportions	tỷ lệ
propose	đề xuất
prosecute	truy tố
prosecutor	công tố viên
prospect	viễn cảnh
prosper	thịnh vượng, phát đạt
prospered	đã - phát đạt, thành công
prosperous	thịnh vượng
prostitute	mại dâm
prostrate	nằm sóng soài; làm kiệt sức
protect	bảo vệ
protected	đã bảo vệ
protection	sự bảo vệ
protest	phản đối
protested	phản đối
protruded	nhô ra
protruding	nhô ra
proud	tự hào
proudly	tự hào
prove	chứng minh
proved	chứng minh
provide	cung cấp
provision	cung cấp
provocation	sự chọc ghẹo
provoke	kích động
prowess	sức mạnh, oai phong
prowled	lảng vảng
prudent	khôn ngoan
pry	nâng lên; tò mò; dọ dẵm
ptarmigan	chim thuộc loại gà có lông sắc đen
puberty	tuổi dậy thì
public	công khai
public hearing	phiên tòa công khai
public school	trường công
publication	công bố
puddle	vũng nước nhỏ
pug	chó mặt bẹt
pull	kéo
pulled	đã kéo
pulling	đang kéo
pullman	toa xe lửa hạng sang có chổ ngủ
pulse	xung
pumping	đang bơm
pumpkin	bí đỏ
punctual	đúng giờ
punctuation mark	ấu chấm câu
punish	phạt
punished	đã bị trừng phạt
punishment	trừng phạt
pupil	học sinh
puppet	con rối
puppy	con cún
purchase	mua
pure	tinh khiết
pure bred	thuần chủng, không lai
purebred	thuần chủng
purify	làm sạch
purple	màu tía
purpose	mục đích
purposed	đã có mục tiêu
purposely	một cách cố ý
purse	ví (nữ)
pursue	theo đuổi
pursued	theo đuổi
pursuit	theo đuổi
push	đẩy
pushed	đã đẩy
put	đặt
putting	đang đặt
puzzle	câu đố
puzzled	đã bối rối
quail	nữ sinh viên
quality	chất lượng
quantity	số lượng
quarrel	cãi nhau
quarrelled	đã cãi nhau
quarrelling	đang cãi nhau
quarry	mồi
quarter	quý
quarters	những quý, phần tư, (nghỉa bóng "no quarters": không nhường)
quaver	người ca run
queen	nữ hoàng
queer	lạ lùng
quest	nhiệm vụ
question	câu hỏi
quibble	không phân minh
quick	mau
quickened	đã làm nhanh hơn
quickly	mau
quickness	tính mau chóng
quiet	yên tĩnh
quietly	lặng lẽ
quill	lông chim
quilt	may chăn
quit	bỏ
quite	khá
quivered	đã run lên
quivering	đang run rẩy
quiz	kỳ thi vấn đáp
quotation mark	dấu ngoặc kép
quote	Trích dẫn
quoth	đã nói (từ cổ)
quoting	đang trích dẫn
rabbit	thỏ
race	chủng tộc; (cuộc) đua
raced	đã chạy đua
races	những chủng tộc, tranh đua
racial	thuộc về chủng tộc
rack	cái giá
radiate	tỏa
radical	cấp tiến
radio	ra đi ô
radioactive	phóng xạ
radius	bán kính
raft	cái bè
rafted	cái bè
rag	giẻ
rage	cơn thịnh nộ
raged	đã phẩn nộ
ragged	đã tả tơi
raging	đang phẩn nộ
raid	cuộc đột kích
rail	lan can
railroad	đường sắt
railway	đường sắt
rain	mưa
raincoat	áo mưa
raise	nâng cao
raised	đã - nâng lên/nuôi nấng
raisin	nho khô
raisins	nho khô
rake	cào
rally	cuộc biểu tình
ram	húc đầu
ramble	đi dạo chơi
rampage	nổi xung
rampant	hung hăng; lan tràn
ramshackle	xiêu vẹo, đổ nát, củ kỷ
ran	đã chạy
ranch	trang trại
random	ngẫu nhiên
rang	vang
range	phạm vi, tầm
ranged	trong - phạm vi, tầm
ranging	đang trong - phạm vi, tầm
rank	xếp hạng
ransom	tiền chuộc
rap	bị la mắng
rape	hiếp dâm
rapid	nhanh; ghềnh, thác của sông
rapidity	sự nhanh
rapidly	một cách nhanh chóng
rapids	những ghềnh, thác của sông
rapped	cú đánh nhẹ, cái gõ, cái cốp
rare	hiếm
rarely	một cách hiếm hoi
rascal	kẻ bất lương
rash	phát ban
rashness	sự - dại dột, bồng bột
rat	chuột
rate	tỷ lệ
rather	hơn
ration	lương thực
rational	hợp lý
rattle	kêu lạch cạch
rattled	đã làm - kêu lách cách; lo lắng
ravage	tàn phá
raven	con quạ
ravenous	ngấu nghiến; đói cào cả ruột
raw	còn sống(chưa chín); thô, chưa tinh chế
ray	tia
reach	với tới, đạt tới
reached	đạt
reaches	với tới, đạt tới
reaching	đang - với tới, đạt tới
react	phản ứng
read	đọc
reading	đọc
ready	sẵn sàng
real	thật
realities	thực tế
reality	thực tế
realize	nhận ra
realized	đã nhận ra
really	thực sự
realm	lĩnh vực, vương quốc
realtor	môi giới bất động sản
reap	gặt hái
rear	sau đuôi
reared	nuôi
rearing	đang nuôi nấng
rearranging	sắp xếp lại
reason	lý do
reasonable	hợp lý
reasoned	đã lý luận
reassemble	lắp ráp
reassure	trấn an
reassured	đã - làm yên tâm, cam đoan một lần nữa
rebel	nổi loạn
rebels	nổi loạn, phiến quân
rebound	bật lại
recall	nhớ lại
recalled	nhớ lại
recede	đi xa
receding	đang lùi
receipt	biên lai
receive	nhận
received	đã nhận được
receiving	đang nhận
recent	gần đây
recess	nghỉ giải lao
recesses	những lúc giải lao
recipe	công thức
reciprocal	đôi bên
recital	sự kể lại
recitation	kể chuyện
recite	đọc
reckon	coi là
reclaim	đòi lại
recline	tựa trên vật gì
recognize	nhận ra
recognized	đã công nhận
recollect	nhớ lại
recollections	hồi ức
recommend	giới thiệu
reconcile	hòa giải
reconstruct	tái cơ cấu
record	ghi chép
recount	kiểm lại
recover	phục hồi
recovered	đã phục hồi
recovery	phục hồi
recruit	tuyển dụng
rectangle	hình chữ nhật
rectum	trực tràng
recuperated	đã hồi phục
recuperation	sự khỏe lại
recur	tái diễn
recurrent	tái phát
red	đỏ
redeem	chuộc lại
red-eyed	mắt đỏ
red-handed	quả tang
reduce	giảm
reef	dải san hô
reel	ống, cuộn
reeled	đã - cuốn lên, quay lên
refer	tham chiếu
refil	làm cho đầy lại
refine	tinh chế
reflect	phản ánh
reflex	ánh sáng phản chiếu
reform	cải cách
refrain	kiềm chế
refresh	làm mới
refreshed	làm mới
refrigerator	tủ lạnh
refuge	nơi trú ẩn
refund	hoàn trả
refuse	từ chối
refused	đã từ chối
refusing	đang từ chối
regain	lấy lại
regained	đã lấy lại
regard	coi là
region	khu vực
register	đăng ký
registering	đang đăng ký
regret	hối tiếc
regular	thường xuyên
regularity	sự thường xuyên
regularly	một cách thường xuyên
rehearsal	diễn tập
reign	cai trị
rein	dây cương
reinforce	củng cố
reject	từ chối
rejoin	gắn
rejoinder	lời - đáp lại, cãi lại
relate	liên quan
relations	những quan hệ
relationship	mối quan hệ
relative	họ hàng
relatively	tương đối
relax	thư giãn
relaxed	thoải mái
release	phát hành
released	phát hành, thả ra
releasing	phát hành, thả ra
relevant	liên quan
relief	cứu trợ
religion	tôn giáo
reluctant	miễn cưỡng
reluctantly	miễn cưỡng
rely	dựa vào
remain	vẫn còn
remainder	phần còn lại
remained	đã vẫn còn (lại)
remark	nhận xét
remarkable	đáng chú ý, suất xắc
remarkably	một cách - đáng chú ý, suất xắc
remarked	đã - nhận xét, nêu ý kiến
remedy	biện pháp khắc phục
remember	nhớ
remembered	đã nhớ
remind	nhắc nhở
remnant	còn sót lại
remnants	còn sót lại
remonstrance	sự khiển trách
remorse	hối hận
remote	sâu xa
remotely	một cách từ xa
remoter	xa xôi
remotest	xa xôi nhất
remove	loại bỏ
removed	loại bỏ
rend	xé
render	trả lại
rending	sự xé nát
renew	làm mới
renounce	từ bỏ
rent	thuê
repair	sửa chữa
repay	trả lại
repeat	lặp lại
repeated	đã lặp đi lặp lại
repeatedly	một cách - lặp đi lặp lại
repellent	thuốc trừ sâu
repent	ăn năn
repetition	lặp lại
replace	thay thế
replaced	đã thay thế
replied	đã trả lời
replies	trả lời
reply	trả lời
report	báo cáo
reporter	phóng viên
repose	nghi ngơi
represent	đại diện
reproach	làm nhục nhã
reproduce	sinh sản
reproof	sự khiển trách; làm cho không thấm nước lại
republic	nước cộng hòa
repugnance	sự ghê tởm
reputation	danh tiếng
request	yêu cầu
require	yêu cầu
required	đã yêu cầu
requires	yêu cầu
rescue	cứu
rescued	cứu
research	nghiên cứu
resemble	giống
resent	tức giận
resented	bực bội
reserve	dự trữ
reserved	đã - trữ, dự bị
reservoir	hồ chứa
resided	đã cư trú
residence	cư trú
resign	từ chức
resignation	từ chức
resignation letter	lá thư từ chức
resiliency	sự giựt lùi
resist	chống lại
resolutely	một cách kiên quyết
resolve	giải quyết
resolved	đã giải quyết
resounding	đang vang dội
respect	tôn trọng, kính nể
respectful	tôn trọng
respond	trả lời
responded	trả lời
responding	đáp ứng
response	phản ứng
responsibility	trách nhiệm
rest	phần còn lại
restaurant	nhà hàng
rested	nghỉ ngơi
resting	nghỉ ngơi
restlessly	không ngừng
restlessness	sự không cử động
restore	khôi phục
restrain	hạn chế
restrict	hạn chế
restroom	nhà vệ sinh
result	kết quả
resulting	đang tạo kết quả
resume	tiếp tục
resumed	trở lại
retail	bán lẻ
retain	giữ lại
retained	giữ lại
retaliated	đã trả đũa
retard	trì hoãn
retarded	đã chậm phát triển; bị bệnh khờ
retarding	chậm
retraced	hồi tưởng lại
retract	rút lại
retreat	rút lui
retreated	đã rút lui
retrieve	lấy lại
retrogression	sự thoái hóa
return	trở lại
returned	đã trở lại
returning	đang trở về
reveal	tiết lộ
revelation	sự tiết lộ; mặc khải
revenge	trả thù
reverently	cung kính
reverse	Ngược lại
review	xem xét lại
revise	xem lại
revive	làm sống lại
revolt	cuộc nổi dậy/loạn
revolver	súng lục (ổ quay)
revolver-shot	tiếng khẩu súng lục (ổ quay)
reward	khen thưởng
rewarded	khen thưởng
rhythm	nhịp điệu
rib	xương sườn
ribbons	những cái ruy băng
ribs	những cái xương sườn
rich	giàu
rid	loại bỏ
riddled	bị đố hóc búa; đã thủng nhiều lổ
ride	chuyến đi
ridicule	chế nhạo
ridiculous	vô lý
riding	cưỡi
riding-whip	roi - cưỡi, đánh xe
rifle	súng trường
rift	kẻ hở
right	đúng, bên phải
right away	ngay lập tức
right now	ngay bây giờ
rigid	cứng nhắc
rigorous	nghiêm ngặt
rim	vành (bánh xe)
ring	vòng
ring finger	ngón áp út
rink	sân - băng, trượt băng; đi trên băng
riot	bạo động
riotously	phá rối
rip	xé
ripe	chín
ripped	đã (bị) xé/tách rời
ripping	trích xuất
rippling	gợn sóng
rips	xé/tách rời
rise	tăng lên, lên cao
rising	đang tăng
risk	nguy cơ
risks	những rủi ro
rival	tranh đấu; đối phương
river	sông
rivers	sông
roach	con gián
road	đường
roamed	đi lang thang
roar	kêu la
roared	đã gầm lên
roaring	đang gầm lên
roast	thịt quay
rob	cướp
robbed	đã bị cướp
robber	kẻ cướp
robbing	cướp
robe	áo choàng
robes	những cái áo choàng
robust	mạnh mẽ
rock	cục đá; lắc lư
rocking	lắc lư
rocks	đá
rod	thanh
rode	đã cưỡi
rogue	thằng nhóc
roll	lăn
rolled	đã cuộn
rolling	lăn, cuộn
rolls	lăn, cuộn
romance	sự lãng mạn
romped	chơi đùa mạnh bạo
roof	cái mái che
rookie	tân binh
room	phòng
roosted	chuồng gà, chổ nghỉ ngơi
root	rễ (cây)
rope	dây
ropes	những sợi dây thừng
rose	hoa hồng; đã tăng lên
rot	thối
rotted	bị mục nát
rotten	hư
rough	thô
roughly	khoảng
rounded	đã làm tròn
rounding off	làm tròn
roundly	một cách tròn trặn
rouse	gây ra
roused	đã đánh thức
routed	đã định đường
rove	đi lang thang
roved	lang bạt
row	một hàng; chèo
rows	những hàng; chèo
royal	hoàng gia
rub	xoa
rubbed	đã cọ xát
rubber	cao su
rubbish	rác
ruction	sự huyên náo
rude	thô lỗ
rug	màn
ruin	làm hỏng
rule	cai trị; định luật
ruled	đã cai trị
ruler	người cai trị
rumble	tiếng ầm ầm
run	chạy
runners	chạy
running	đang chạy
runs	chạy
rush	hối thúc; vội vàng; lao vào
rushed	đã - vội vã; lao vào
rushes	hối thúc; lao vào
rushing	đang - hối thúc; vội vàng; lao vào
rust	gỉ
rustled	kêu xào xạc, kêu sột soạt; hối hả
rut	sự cọ nhau
ruthless	tàn nhẫn
sack	bao
sacked	bị sa thải, bỏ trong bao tải
sacks	bao tải
sacred	thiêng liêng
sacrifice	hy sinh
sacrificed	đã hy sinh
sad	buồn
saddle	yên xe
safe	an toàn
safety	sự an toàn
sag	độ cong
sage	nhà hiền triết
sagged	đã oằn xuống
said	đã nói
sail	buồm
saint	thánh
sake	lợi ích
sakes	vì
salary	tiền lương
salesman	nhân viên bán hàng
salient	phun ra
saliva	nước bọt
salmon	cá hồi
saloon	quán rượu
saloon-keeper's	của chủ quán rượu
salt	muối
salute	chào
salve	xoa dịu
same	như nhau
sample	mẫu
sanctuary	nơi tôn nghiêm
sand	cát
sane	phải chăng
sang	đã hát
sanitary	vệ sinh
sanitate	làm vệ sinh
sank	đã chìm
sap	nhựa cây; hầm, hào
sapped	làm mất hết (sinh lực); phá hoại
sat	đã ngồi
satellite	vệ tinh
satire	châm biếm
satisfaction	sự hài lòng
satisfied	hài lòng
satisfy	đáp ứng
saturate	bão hòa
Saturday	Thứ Bảy
sausage	xúc xích
savage	tàn ác; man rợ; không văn minh
savagely	một cách - tàn ác; man rợ; không văn minh
savageness	man rợ
savagery	tính - tàn ác; man rợ; không văn minh
savages	những kẻ man rợ
save	tiết kiệm; cứu
saved	đã (được)- lưu, tiết kiệm; cứu
savor	hương thơm
savory	ngon
saw	đã thấy
saw-logs	gổ làm nhà đã cưa
saw-mill	máy cưa lớn
say	nói
say?	nói gì?
saying	nói
says	nói
scald	chổ phỏng
scale	quy mô, cái cân; leo
scaled	đã leo
scales	cân; (leo)
scallion	hành ta
scalp	da đầu
scandal	vụ bê bối
scar	vết sẹo
scarce	khan hiếm
scarcely	hầu như không
scare	sợ hãi
scarecrow	bù nhìn
scarlet	màu đỏ tươi
scarring	sẹo
scatter	tản ra
scattered	rải rác
scattering	đang phân tán
scene	cảnh
scent	hương thơm
scented	đã có mùi thơm
scenting	đánh hơi
scew	đinh vít
schedule	lịch trình
scheme	Đề án
scholar	học giả
school	trường học
schools	trường học
science	khoa học
scissor	cái kéo
scold	la mắng
scoop	cái xẻng
scope	phạm vi
scorch	làm cháy sém
score	điểm số
scored	đã ghi điểm số
scorn	khinh miệt
Scotch	(thuộc) nhân dân Ê-cốt
scour	sự lau
scout	lính trinh sát
scowl	cau có
scrabble	viết ngoáy
scramble	trườn sang
scrambling	đang - xáo trộn, loạn xạ
scrap	phế liệu
scrape	cạo
scraped	cạo
scratch	gãi
scratched	đã - cào, trầy xước
scream	hét lên
screamed	hét lên
screaming	đang la hét, kêu gào
screen	màn hình
screw	vặn chặt
scribble	viết nguệch ngoạc
script	kịch bản
scripture	Kinh Thánh
scroll	di chuyển
scrub	cọ sạch
scruff	cái gáy
scruple	thận trọng
sculpture	điêu khắc
scum	bọt, váng, cặn bã
sea	biển
seal	niêm phong
seam	đường may nổi
seaport	cảng biển
search	tìm kiếm
searched	tìm kiếm
season	mùa
seasons	mùa
seat	chỗ ngồi
seclude	sống tách biệt
second	giây; đứng thứ 2
second hand	đồ dùng rồi
seconded	thêm lời sau, đáp lời sau
secrecy	bí mật
secret	bí mật
secretary	Thư ký
secretly	một cách bí mật
section	phần
sections	phần
secure	đảm bảo
secured	đã bảo đảm
securely	một cách an toàn
sediment	trầm tích
seduce	dụ dỗ
see	xem
seed	hạt giống
seeing	đang nhìn thấy
seek	tìm kiếm
seeking	tìm kiếm
seem	dường như
seem'	dường như
seemed	đã dường như
seeming	đang dường như
seems	dường như
seen	đã thấy
segment	phân khúc
segregate	phân loại
seize	nắm bắt
seized	thu giữ
seizure	bắt
select	chọn
selected	đã chọn
self	bản thân
self-appointed	tự chỉ định
self-discipline	tính kỷ luật tự giác
selfish	ích kỷ
sell	bán
senate	thượng nghị viện
senator	Thượng nghị sĩ
send	gửi
senior	cao cấp
sensation	cảm giác
sensations	cảm giác
sense	giác quan, ý nghĩa
sensed	cảm nhận
senseless	không có cảm giác, bất tỉnh, điên rồ; vô nghĩa
senses	những giác quan
sensitive	nhạy cảm
sent	đã gửi
sentence	câu
sentimental	ủy mị
separate	riêng biệt
separated	tách
September	Tháng Chín
sequence	trình tự
sequential	tuần tự
serene	thanh bình
sergeant	trung sỹ
serial	nối tiếp
serious	nghiêm trọng
sermon	bài thuyết giáo
serpent	con rắn
servants	người - phục vụ, hầu
serve	phục vụ
served	phục vụ
set	đặt; (một) bộ
setter	người đặt
setting	thiết lập
settle	giải quyết
settles	giải quyết
seven	7
seventeen	mười bảy
seventh	thử bảy
seventy	70
several	một số, vài
severe	nghiêm trọng
severely	nghiêm trọng
sew	may
sewer	máy may
sex	quan hệ tình dục
sex-prerogative	giới tính đặc quyền
shade	che
shades	màu
shadow	bóng
shadows	bóng tối
shaggy	rậm rạp
shake	rung
shaken	lắc
shaking	lắc
shallow	nông
shambled	lê bước
shambling	lê bước
shame	xấu hổ
shank	chân
shape	hình
share	chia
shark	cá mập
sharp	bén, sắc nét
sharply	một cách sắc bén
shave	cạo râu
she	cô
shear	xén
shed	đã đổ
sheen	nước bóng
sheep	cừu
sheepishly	một cách e thẹn
sheer	tuyệt đối; vải mỏng dính
sheet	tờ, tấm
shelf	kệ
shell	vỏ
shellfish	động vật có vỏ
shelter	nơi trú ẩn
sheltered	đã (được) che chở
sheltering	đang trú ẩn
shepherd	người - chăn cừu, trông nom
sheriff	người đứng đầu hạt
shift	thay đổi
shifted	đã chuyển
shifting	đang chuyển
shine	tỏa sáng
shining	sáng
ship	tàu
shipping	đang vận chuyển
shirked	đã trốn việc
shirks	những hành vi trốn tránh
shiver	run lên
shivered	đã rùng mình
shivering	đang run rẩy
shock	sốc
shoes	những chiếc giày
shone	chiếu sáng
shook	đã - lắc, lay động
shoot	bắn
shoots	bắn
shop	cửa hàng
shore	bờ biển
shores	những bờ biển
shoreward	hướng bờ biển
short	ngắn
shortcut	đường tắt
shorter	ngắn hơn
short-haired	tóc ngắn
short-legged	chân ngắn
shortly	một chốc ngắn
shorts	quần soóc
shot	đã bắn
should	sẽ, nên
shoulder	bờ vai
shoulder-blade	xương vai
shoulders	những bờ vai
shouldn't	không nên
shout	kêu la
shouted	đã hét lên
shouting	la hét
shove	xô
show	trưng bày; chỉ, bảo, dạy
showed	đã - cho thấy, trưng bày; chỉ, bảo, dạy
shower	tắm bằng vòi hoa sen
showing	đang - cho thấy, trưng bày; chỉ, bảo, dạy
shown	đã - cho thấy, trưng bày; chỉ, bảo, dạy
shreds	sợi
shrewd	đầy tính toán
shrewdly	một cách - khôn ngoan, tính toán
shriek	thét
shrieked	đã rít/thét lên
shrieking	đang rít/thét lên
shrill	kêu the thé, rít lên in tai nhức óc
shrimp	tôm
shrink	rút ngắn
shrouded	bao phủ
shrubs	cây bụi
shrug	nhún vai
shrugged	đã - nhún vai, giũ sạch
shunned	đã tránh xa
shutting	đang - tắt, đóng
shy	nhút nhát
sick	ốm
sickly	hay đau
side	bên
side effect	tác dụng phụ
sided	mặt
sides	những bên
sidewalk	vỉa hè
sigh	tiếng thở dài
sight	tầm nhìn, ánh mắt
sights	những cảnh quan
sightseeing	tham quan
sign	ký, dấu hiệu
signed	đã - ký, đưa dấu hiệu
signs	dấu hiệu
silence	sự im lặng
silent	im lặng
silient	yên tĩnh
silk	tơ lụa
silky	mướt
silly	ngốc nghếch
silver	bạc
silvery	lóng lánh như bạc
similar	như nhau
simmer	nấu sôi
simple	đơn giản
simply	một cách đơn giản
simulate	mô phỏng
simulated	mô phỏng
simultaneous	đồng thời
sin	tội
since	kể từ khi
sinew	bắp thịt; sức khoẻ; nguồn tiếp sức, rường cột
sing	hát
singer	ca sỹ
singing	đang hát
single	duy nhất, đơn độc
sings	hát
sing-song	hát bài hát
sink	chìm
sinking	đang chìm
sinks	bồn, chìm
sinnk	bồn rửa bát
sip	nhâm nhi
sir	ngài
sister	chị gái
sister in law	chị dâu (em dâu)
sisters	chị em
sister's	của chị/em gái
sit	ngồi
site	địa điểm
sitting	ngồi
situation	tình hình
six	6
sixteen	mười sáu
sixth	thứ sáu
sixty	60
sixty-mile	sáu mươi dặm
size	kích cở
skeletons	những bộ xương
skid	trượt bánh
skill	kỹ năng
skillful	khéo léo
skim	hớt bọt
skin	da
skins	những bộ da
skip	bỏ qua
skirt	váy
skirted	đã đi men
skulking	đang - trốn tránh, lẩn lút, lỉnh
skull	hộp sọ
sky	bầu trời
skyward	lên trời
slack	uể oải
slacked	buông lơi
slake	giải khát
slam	đóng sầm
slammed	đóng sầm
slanted	đã nghiêng
slap	tát
slapping	đang tát
slash	rạch, cắt giảm
slashed	đã - rạch, cắt giảm
slashing	đang - rạch, cắt giảm
slave	nô lệ
slaver	nhỏ dãi
slavered	đã nhỏ dãi
slay	giết
slaying	giết
sled	xe kéo trượt băng
sledded	trượt xe tuyết
sled-dogs	những xe trượt tuyết-chó
sleds	xe trượt tuyết
sleek	trơn
sleep	ngủ
sleeping	đang ngủ
sleeping-robe	áo choàng ngủ
sleepy	buồn ngủ
sleet	mưa tuyết
sleeve	tay áo
slender	mảnh mai
slept	đã ngủ
slice	lát, miếng mỏng
slid	trượt
slide	trượt
slight	nhẹ
slightly	hơi
slim	mỏng
slipped	giảm
slippery	trơn
slipping	trượt
slipshod	cẩu thả
slope	dốc
sloped	dốc
slouch	người chậm chạp
slovenly	ăn mặc cẩu thả
slow	chậm
slower	chậm hơn
slowly	một cách từ từ
sluggish	chậm chạp
sluice	cửa cống, cống; ào chảy mạnh
slyly	một cách kín đáo
small	nhỏ
smart	thông minh
smash	phá
smashed	đã đập nát
smashing	đập nát
smear	bôi chất nhờn, bôi chất dính
smell	mùi; ngửi
smelled	mùi
smelling	đang ngửi
smells	mùi
smile	nụ cười
smiled	đã mỉm cười
smiling	đang mỉm cười
smoke	hút thuốc lá
smooth	mịn
smother	làm ngột thở
smothered	đã - trong tình trạng âm ỉ; làm ngạt thở; giấu giếm
smudge	làm bẩn
smuggle	buôn lậu
snack	bữa ăn nhẹ
snags	cừ, cọc gổ; sự trở ngại bất ngờ
snail	ốc sên
snake	con rắn
snap	cái táp/đớp; tiếng gãy răng rắc; đột xuất
snapped	đã - táp/đớp; gãy răng rắc
snapping	đang - táp/đớp; chụp
snaps	cắn, táp; tiếng gãy rắc
snarl	(tiếng)gầm gừ
snarled	đã gầm gừ
snarling	đang gầm gừ
snatch	giật lấy
sneak	trốn, lẻn
sneakers	giày thể thao
sneered	chế nhạo
sneering	chế nhạo
sneeze	hắt hơi
sniff	ngửi
sniffed	đã ngửi
sniffing	đánh hơi
sniffs	ngửi
snore	ngáy
snort	(tiếng) khịt mũi
snow	tuyết
snowdrifts	những cơn gió tuyết
snowed	tuyết đã rơi
snowfall	tuyết rơi
snows	tuyết
snowshoe	giày đi tuyết
snow-white	tuyết trắng
snub	mũi tẹt và hếch; chỉnh, làm nhục, làm mất mặt
snubbed	chỉnh, làm nhục, làm mất mặt
snubbing	chỉnh, làm nhục, làm mất mặt
snug	vừa khít
so	để
soak	ngâm
soap	xà phòng
soars	tăng vọt, bay bổng
sob	khóc nức nở
sobbed	đã khóc nức nở
sobbing	đang thổn thức
sober	tỉnh táo
social	xã hội
society	xã hội
socks	tất
soft	mềm
softened	đã trở thành mềm
softer	mềm, nhẹ nhàng hơn
softly	một cách - mềm mại, nhẹ nhàng
soft-sighing	thở dài nhẹ
soil	đất
solar	thuộc về mặt trời
sold	bán
soldier	người lính
sole	duy nhất
solemn	trang nghiêm
solid	rắn
solidarity	sự đoàn kết
solidly	một cách - kiên cố, chắc chắn
soliloquized	đã - nói một mình, độc thoại
solitary	cô độc
soluble	hòa tan
solution	giải pháp
solve	giải quyết
sombre	tối
some	một số/vài
somehow	bằng cách này hay cách khác
something	một cái gì đó
sometimes	đôi khi
somewhat	hơi
somewhere	một nơi nào đó
son	con trai
son in law	con rể
song	bài hát
songs	những bài hát
sons	những người con trai
soon	sớm
sooner	sớm hơn
soothe	làm dịu
sore	đau
sorely	một cách - đau đớn, ê chề
sorrow	nỗi buồn
sorry	xin lỗi, đau buồn
sort	phân loại
sorts	các loại
sou	xu
sought	tìm kiếm
soul	tâm hồn
sound	âm thanh
sounded	nghe
sounding	đang - kêu, vang tiếng
soundly	một cách - đúng, đứng đắn, đầy đủ
sounds	những âm thanh
sour	chua
source	nguồn
sourer	chua hơn
south	hướng nam
southland	vùng đất hướng nam
space	không gian
spaces	không gian
spacious	rộng rãi
spare	dự phòng
spark	tia lửa
sparks	tia lửa
sparrow	chim sẻ
spasm	sự co thắt
spasmodically	một cách - co thắt; lúc có lúc không; lác đác
spat	sự cải nhau
speak	nói
spear	thương
spears	ngọn dáo
special	đặc biệt
specific	cụ thể
specimen	mẫu
spectator	người xem
speculate	đầu cơ
sped	đã vọt nhanh
speech	bài phát biểu
speed	tốc độ
speedily	một cách mau lẹ
spell	đánh vần
spend	tiêu
spent	tiêu
sphere	phạm vi
spicy	gia vị
spider	nhện
spill	làm đổ
spilling	tràn
spin	quay
spine	xương sống
spinning	quay
spiral	xoắn ốc
spirit	tinh thần
spirit-broken	tinh thần bị phá vỡ
spit	sự khạc nhổ
spite	Mặc dù
splash	làm bắn
splashes	nước văng tung toé
splay	xoay ra ngoài
splendid	lộng lẫy, huy hoàng; tuyệt, tốt
splendor	huy hoàng
splinter	mảnh vụn
splintering	đang vỡ vụn
split	chia
spluttered	lắp bắp
spoil	làm hư hỏng
spoiled	hư hỏng
spoke	đã nói
spontanous	tự phát
spoon	thìa
spot	điểm, nơi, chấm; nhìn thấy
spouse	người phối ngẫu
spouted	mọc mầm
sprang	đã - mọc, nhẩy
spray	phun, xịt
sprayed	đã phun
spread	lây lan, tỏa lan
spring	mùa xuân, suối, lò xo, cái nhảy
springiness	tính co dãn, tính đàn hồi
springs	lò xo
springtime	mùa xuân
sprint	chạy nước rút
sprout	búp
spruce-bough	cành cây vân sam(loại thông)
sprung	bung lên
spurred	đã thúc đẩy
spy	gián điệp
squabbling	đang cãi nhau
square	hình vuông
squarehead	đầu ngốc
squarely	một cách vuông vắn
squatted	đã quì
squaw	đàn bà da đỏ
squeeze	ép
squid	mực
squirmed	đã quằn quại
squirrel	con sóc
squirrels	sóc
squishy	mềm
stab	đâm
stable	ổn định
stables	những cái chuồng
stack	chất đống
stage	sân khấu
stagger	lảo đảo
staggered	đã loạng choạng
staggering	đang - loạng choạng; đáng kinh ngạc
stain	vết
stair	cầu thang
stalk	thân cây
stalked	đã theo dõi
stamp	tem
stamped	đã - đóng dấu, giậm chân
stand	đứng
standard	tiêu chuẩn
standing	đang đứng
stands	đứng; những giá, mắc (áo, ô)
standstill	sự ngừng lại, đứng yên
star	ngôi sao
stars	những vì sao
start	bắt đầu
started	đã bắt đầu
starting	bắt đầu
starts	bắt đầu
starvation	cái đói
starved	đói
starves	bỏ đói
starving	đang đói
state	trạng thái, tiểu bang, nhà nước
stated	đã quy định
stately	oai nghiêm
station	trạm
statue	tượng
stay	ở
staying	ở
stead	thay vì, thay mặt cho ai
steadily	một cách - ổn định, đều đặn
steal	ăn cắp
stealing	ăn cắp
stealthily	vụng trộm
steamer	tàu chạy bằng hơi nước
steamship	thuyền chạy bằng hơi nước
steel	thép
steep	dốc
steeped	ngập tràn
steeply	dốc
step	bước
stepped	bước
steps	những bước
stern	nghiêm khắc, lạnh lùng
stick	cây gậy; dính
sticks	những cây gậy; dính
stiff	cứng, đơ
stiffness	độ cứng
still	vẫn còn
stinging	đau nhói
stir	khuấy
stirred	đã khuấy
stirring	đang khuấy
stirrings	rung động
stole	đã ăn cắp
stomach	dạ dày
stone	đá
stood	đã đứng
stooped	khom
stop	thôi
stopover	sự ngừng hẳn
stoppage	sự tạm nghi
stoppages	những sự ngừng lại
stopped	dừng lại
stopping	dừng lại
store	cửa hàng; lưu trữ
stormed	đã - xông vô, bị bão
story	câu chuyện
stout	vạm vỡ
stoutest	vạm vỡ nhất
stoutly	mạnh mẽ, rắn chắc
straight	ngay thẳng
strain	sự căng thẳng
strained	đã căng thẳng
straining	đang căng thẳng
strange	lạ
strangely	một cách lạ lùng
stranger	người lạ
strangers	những người lạ
strangle	thắt cổ
strangling	bóp nghẹt
strapped	ràng chặt
straps	những dây đai
straw	rơm
strawberries	dâu
stray	đi lạc
stream	sông
streamed	trực tiếp
streaming	đang chảy theo dòng
streamlet	suối nhỏ
streams	suối
street	đường phố
strength	sức mạnh
stretch	căng ra
stretched	đã kéo dài
stretches	trải dài
stricken	bị ảnh hưởng
strife	sự xung đột
strike	tấn công; sự biểu tình
striking	đang - đánh, nổi bật
strings	chuỗi
stringy	như có sợi
stripped	tước, xé đi
strips	dải; tước, xé đi
striving	đang phấn đấu
strokes	đột quỵ
stroll	đi dạo
strong	mạnh
stronger	mạnh mẽ hơn
strongly	mạnh mẽ
strove	phấn đấu
struck	đã đánh
struggle	đấu tranh
struggled	đã đấu tranh
struggling	đang đấu tranh
strung	xâu thành chuỗi
strutting	dáng đi khệnh khạng; lấp thanh chống
studying	nghiên cứu
stuff	đồ vật; nhét
stumbled	vấp
stuttered	lắp bắp
style	phong cách
subdued	bị chinh phục
submerged	ngập nước
substitute	thay thế
subtle	tinh tế
subtler	tinh vi hơn
succeed	thành công
succeeded	đã thành công
successful	thành công
successfully	thành công
succession	tiếp
such	như vậy
suck	hút; tệ (lóng)
sudden	đột ngột
suddenly	một cách đột ngột
suffer	đau khổ; chịu tổn thất
suffered	đã - bị đau khổ; chịu tổn thất
suffering	đang - đau khổ; chịu tổn thất
sufficient	đủ, có khả năng
suffocating	nghẹt thở
suggested	đề nghị
sullen	buồn bã
sullenly	một cách buồn bã
sum	tổng hợp
summer	mùa hè
summers	mùa hè
summit	đỉnh
sun	mặt trời
sundays	những ngày chủ nhật
sun-dried	đã hơ khô với ánh nắng
sun-kissed	nắng ấm
sunland	vùng đất đầy mặt trời
sunshine	ánh nắng mặt trời
superfluous	dư dả
superior	trội, cao cấp hơn
supper	bưa ăn tối
supply	cung cấp
suppose	giả sử
suppress	ngăn chặn
suppress 	đè nén
suppressed	bị đàn áp
suppressedly	một cách đè nén
supremacy	quyền tối cao
supreme	tối cao
surcharged	phí cộng thêm
sure	chắc chắn
surely	chắc chắn
surface	bề mặt
surge	tăng
surged	đã tăng
surgeon	bác sĩ phẫu thuật
surging	đang tăng
surprise	bất ngờ
surprised	đã ngạc nhiên
surprising	đang đáng ngạc nhiên
surrounded	đã bao quanh
survey	khảo sát
surveyed	đã khảo sát
survive	tồn tại
survived	sống sót
surviving	còn sống sót
survivors	người sống sót
suspicious	khả nghi
swaggering	đang nghênh ngang
swam	bơi
swarming	swarming
swart	sậm, ngăm ngăm đen
swarthy	tốI sậm, ngăm đen
swayed	bị ảnh hưởng
swearing	sự tuyên thệ
sweater	áo len
sweating	đang đổ mồ hôi
sweep	quét
sweeping	quét
sweet	thơm
sweethearts	yêu nhau
swelled	tăng lên
swelling	đang sưng
swept	đã quét
swift	nhanh
swiftly	một cách nhanh chóng
swimmer	người bơi
swimming	đang bơi
swimming-tank	hồ bơi
swing	đung đưa, đu
swinging	đang - đung đưa, đu
swirl	xoáy
swollen	đã sưng lên
swore	đã thề
sworn	tuyên thệ nhậm chức
swung	đã vung
sympathetically	thông cảm
system	hệ thống
table	bàn
tables	bảng
tack	đồ ăn
tact	khéo léo
tail	đuôi
tailor	thợ may
tails	những cái đuôi
taint	vết bẩn
take	lấy
take off	cất cánh
taken	đã lấy
takers	người nhận
taking	đang lấy
tale	câu chuyện
tale-bearing	mang câu chuyện
talent	tài năng
talk	nói
talked	đã nói chuyện
talking	nói
tall	cao
tame	thuần hóa
tamed	đã thuần hóa
tamper	giả mạo
tangerine	quả quýt
tangible	hữu hình
tangle	làm rối
tangled	đã rối
tank	xe tăng; cái bồn chứa; nhào xuống
tantalize	trêu ngươi
tap	vòi (nước)
tape	băng
tardy	muộn
target	mục tiêu
tariff	thuế quan
tarnish	làm lu mờ
tart	chát
task	nhiệm vụ
taste	hương vị
tasting	nếm
taught	đã giảng dạy
taunt	chế nhạo
taunted	đã chế giễu
taut	khẩn trương
tax	thuế
tax free	miễn thuế
tea	trà
teach	dạy
teacher	giáo viên
teachers	những giáo viên
teaching	đang giảng dạy
team	đội
team-dogs	những đội chó
team-mates	những đồng đội
teams	những đội
tear	giọt nước mắt
tearing	rách, xé
tears	nước mắt
tease	trêu chọc
teasing	đang trêu chọc
technical	kỹ thuật
technician	kỹ sư
tedious	tẻ nhạt
teeth	răng
telephone	điện thoại
telephone number	số điện thoại
television	tivi
tell	nói
telling	nói
temper	tính khí
temperature	nhiệt độ
tempers	những sự nóng giận
temple	chùa
temporal	trần tục
temporary	tạm thời
tempt	dụ dổ
ten	10
tenant	người thuê nhà
tend	có xu hướng
tender	đấu thầu
tenderfoot	người mới đến
tendon	gân
tendons	những sợi gân
tense	căng thẳng
tent	lều
tent?	lều?
tenth	thứ mười
tents	những túp lều
term	khoản
terminal	gải
terminate	chấm dứt
terms	về
terrible	khủng khiếp
terribly	khủng khiếp
terrific	tuyệt vời
terrified	đã sợ hãi
terrifying	đang đáng sợ
territory	lãnh thổ
terror	sự - khiếp sợ, khủng bố
terse	gọn
test	kiểm tra
testify	làm chứng
testimony	chứng
text	văn bản
than	hơn
thank	cảm ơn
Thank you	Cảm ơn bạn
that	mà, đó
that's	đó là
thaw	làm tan
thawed	đã tan băng
thawing	đang tan băng
the	cái/quả/quyển/người/con….
the other side	phía bên kia
theater	nhà hát
theft	trộm
their	của chúng/họ
theirs	của họ
them	chúng/họ
themselves	chính chúng nó/họ
then	sau đó
theology	thuyết thần học
theory	lý thuyết
there	đó
there are	có
there is	có
thereafter	sau khi
therefore	do đó
thermometer	nhiệt kế
these	những cái này
they	họ/chúng nó
they're	họ đang
thick	dày
thicket	chổ rậm rạp
thickness	độ dày
thief	kẻ trộm
thigh	đùi
thighs	những cái đùi
thin	mỏng, gầy
thing	cái điều, món
things	những - cái, điều, món
think	nghĩ
thinking	đang suy nghĩ
thinks	suy nghĩ
third	đứng thứ ba
thirst	khát
thirsting	khao khát
thirsty	khát
thirteen	mười ba
thirty	30
thirty-five	35
this	này, đây
thong	roi da; buộc bằng dây da
thorn	gai
thorough	tỉ mỉ
thoroughfare	đại lộ
those	những cái đó
though	tuy nhiên
thought	(đã) suy nghĩ; một ý nghĩ
thoughtless	không suy nghi
thousand	ngàn
thousands	hàng ngàn
thrash	đánh đòn
thrashing	đang đánh đòn
thread	chủ đề
threading	luồng, sợi
threat	mối đe dọa
threaten	đe dọa
threatened	đã bị đe dọa
threatening	đe dọa
threateningly	một cách đe dọa
three	3
threw	đã ném
thrice	ba lần
thrill	sự rộn ràng; rung động
thrilling	xúc động, hồi hộp, ly kỳ
throat	họng
throats	những cái cổ họng
throbbed	đã đập mạnh
throbbing	sự rộn ràng, đập mạnh, nhói
throne	ngôi vua
throttle	bóp cổ
through	xuyên qua
throughout	trong suốt
throw	ném
throwing	ném
thrown	đã ném
thrust	thọc
thrusting	đang đẩy mạnh
thumb	ngón tay cái
thumping	nện, đập mạnh
thunder	sấm sét
Thursday	Thứ Năm
thus	do đó
ticket	vé
ticket booth	gian hàng vé
tickling	bị làm cho buồn buồn
tidal	thủy triều
tide	thủy triều
tides	thủy triều
tide-water	nước thủy triều
tie	dây buộc
tiger	con hổ
tight	chặt chẽ
tightened	đã thắt chặt
tightening	thắt chặt
tightly	chặt chẽ
till	đến lúc
tilt	nghiêng
timber	gỗ làm nhà
time	thời gian
time-card	thẻ giờ
time-graven	dấu ấn thời gian
times	những lần
timid	nhút nhát
tin	thiếc
tingle	có cảm giác ngứa
tinkled	gỏ chuông
tip	chóp
tips	lời khuyên, tiền buộc/bo
tiptoe	nhón gót chân
tire	lốp
tired	mệt mỏi
tireless	chẳng quản khó nhọc
tissue	mô
tissues	những mô của cơ bắp
title	Tiêu đề
to	để (hành động)
toad	con cóc
today	hôm nay
toe	ngón chân
toe nail	móng chân
toenail	móng chân
toes	những ngón chân
together	cùng nhau
toil	vật lộn, làm việc cực nhọc
toiled	đã làm việc vất vả
toilet	nhà vệ sinh
token	mã thông báo
tokens	thẻ
told	nói với
tolerable	có thể chịu được
tolerated	dung nạp, chấp nhận
toll	số điện thoại
tomb	ngôi mộ
tombstone	chữ khắc
tom-fool	tên ngốc
tomorrow	ngày mai
ton	tấn
tone	âm điệu
tongue	lưỡi
tongues	những cái lưỡi
too	cũng vậy; quá
took	đã lấy
tool	công cụ
tools	công cụ
tooth	răng
tooth brush	bàn chải đánh răng
tooth paste	kem đánh răng
toothbrush	bàn chải đánh răng
toothless	không răng
toothpaste	kem đánh răng
top	trên đĩnh
top-heavy	nặng
topic	Chủ đề
topped	đã - đứng đầu, qua đầu
tops	những ngọn
torch	đèn pin
tore	xé
torment	nổi đau khổ
tormentor	kẻ hành hạ
tormentors	những kẻ hành hạ
torn	đã (xé)rách
tornado	bảo tố
torrent	dòng nước chảy xiết
tortoise	rùa
torture	tra tấn
toss	ném
tossed	ném
total	tổng cộng
tote	vận tải
totem-pole	cột gỗ cao, khắc hoặc vẽ một loạt các biểu tượng vật tổ
tottered	lung lay, sắp đổ; đi lảo đảo, chập chững
touch	chạm, sờ
touched	xúc động, chạm
touches	chạm
tough	dai
toughest	khó khăn nhất
tour	chuyến di lịch
toward	đối/đến với
towed	đã kéo
towel	khăn
town	thị trấn
toxin	độc tố
toy	đồ chơi
trace	theo dõi, lần - dấu vết
traces	những dấu vết (trên đường)
track	theo dõi
trade	thương mại
traded	giao dịch
tradition	truyền thống
traffic	giao thông
tragedy	thảm kịch
tragic	bi kịch
trail	tia, đường rầy, con đường nhỏ
trails	những con đường mòn
train	xe lửa
trained	đào tạo
trait	đặc điểm
traitor	kẻ phản bội
traits	đặc điểm
tramp	người đàn bà đĩ thõa
tramping	tàu không định kỳ; sự lẫn bẩn
trampled	đã giẫm xéo
transact	giao dịch
transfer	chuyển giao
transformation	chuyển đổi
transformed	đã chuyển đổi
transforming	đang chuyển đổi
transient	thoáng qua
transition	chuyển tiếp
transitional period	thời kỳ quá độ
translate	dịch
translator	biên dịch viên
transmit	truyền
transparent	rõ rệt
transport	vận chuyển
transportation	giao thông vận tải
trap	bẫy
traps	bẫy
travail	công việc cực khổ
travel	đi du lịch
travelled	đã đi du lịch
travellers	du khách
travelling	đang đi du lịch
treacherous	phản bội
treacherously	một cách phản bội
treachery	sự phản bội
treason	phản quốc
treasure	kho báu
treat	đối xử, điều trị
treated	đã - đối xử, điều trị
treatment	sự - đối xử, điều trị
treaty	hiệp ước
tree	cây
trees	những cái cây
treetops	ngọn cây
tremble	run lên
trembled	đã run rẩy
trembling	đang run rẩy
tremendous	kinh hai
trench	mương
trespass	vi phạm
trespasser	kẻ - xâm phạm nơi cấm vào
trial	thử nghiệm
triangle	hình tam giác
tribe	bộ lạc
tribesmen	bộ lạc
trice	(nhanh) nháy mắt
trick	lừa
tricked	bị lừa
trickle	tia nước
trickling	nhỏ giọt
tricks	những thủ thuật
tricycle	xe ba bánh
tried	đã cố gắng
trifle	chơi giởn
trim	tỉa
trip	chuyến đi
triple	ba
tripped	vấp
triumph	chiến thắng
triumphantly	một cách đắc thắng
trot	chạy nước kiệu
trotted	đã - đi nước kiệu, lon ton
trouble	rắc rối
trouncing	đang - hạ ván, đè bẹp
trouser	quần
truce	sự hưu chiến
truck	xe tải
trucked	đã chở bằng xe tải
true	đúng, sự thật
truly	một cách - thực sự, thành thật
trunk	thân cây
trunks	thân
trust	tin tưởng
truth	sự thật
try	thử, cố gắng
trying	cố gắng
tub	bồn tắm
tuckered	tuckered
Tuesday	Thứ Ba
tug	kéo mạnh
tuition	học phí
tumble	ngã bất thình lình
tumbled	đã - giảm, té nhào
tuna	cá ngừ
tune	điều chỉnh
turn	xoay
turned	đã quay
tutor	gia sư
twelfth	thứ mười hai
twelve	12
twentieth	hai mươi
twenty	hai mươi
twenty-five	25
twice	hai lần
twilight	hoàng hôn
twist	xoắn
twisted	đã xoắn
twitching	co giật
two	2
type	loại
typical	điển hình
ugly	xấu xí
ulcer	loét
ultimate	tột cùng
ultimately	sau cùng, cuối cùng
umbrella	ô
umpire	trọng tài
unable	không thể
unaffected	đã không bị ảnh hưởng
unafraid	không sợ
unaided	không được giúp đở
unaltered	đã không thay đổi
unapproachable	không bì được
unaware	không biết
unbreakable	không thể phá vỡ
unbridled	không cương
unbroken	nguyên, không bị gãy/bể
unbuilt	chưa xây
uncanny	kỳ lạ
uncharted	chưa thám hiểm
uncle	chú, cậu, bác trai
uncles	chú bác
uncoiled	gỡ từ cuộn
unconcern	vô tư lự
unconscious	bất tỉnh
unconsciously	một cách - bất tỉnh/vô ý/không suy nghĩ
uncontent	không hạnh phúc
uncouth	thô kệch; chưa văn minh
uncowed	đã không nao núng
under	dưới
underbrush	bụi rậm
underfeeding	thiếu dinh dưỡng
underfoot	ở dưới bàn chân
undergrowth	bụi rậm
underhand	ám muội, dưới tay
underneath	bên dưới
understand	hiểu
understand?	hiểu không?
understanding	sự hiểu biết
understood	hiểu
undertake	đảm nhận
undervalued	đã bị đánh giá thấp
underwear	đồ lót
undesirable	thiếu hấp dẫn
undid	đã gỡ lại
undreamed	không mơ
undress	trần truồng
unduly	một cách không đúng luật
unearthed	đã khai quật
uneasily	không dễ nắm bắt
unending	đang không dứt
unendurable	không chịu nổi
uneven	không đồng đều
unexpected	đã bất ngờ
unfair	bất công
unfastened	đã tháo ra
unfed	bỏ đói
unfinished	đã chưa xong
unfit	không thích hợp
unforgetable	khó quên
unforgettable	không thể nào quên
unhappy	không vui
unheeded	đã không ai để ý đến
unhesitatingly	không nhứt định
unhitched	tháo ra
unidentified	không xác định
uniform	đồng đều
unify	thống nhất
union	công đoàn
unique	độc đáo
unison	nhất trí
unite	đoàn kết
universal	luật chung, thuộc vũ trụ/vạn vật
university	đại học
unjust	bất công
unkempt	không chải chuốt
unknown	chưa ai biết đến, vô danh
unlike	không giống như
unloaded	bốc dỡ
unlucky	không may
unmistakable	dể nhận ra
unmolested	đã không quấy rầy
unnumbered	đã không có đếm
unpacked	giải nén
unpleasant	khó chịu
unpleasantly	khó chịu
unpursued	đã không theo đuổi
unresisting	đang ngưng chống cự
unrest	lo âu, phập phồng, náo loạn
unrested	unrested
unruly	một cách ngổ nghịch
unseen	không nhìn thấy
unsuspected	đã không nghi ngờ
unswerving	đang khó lay chuyển
until	cho đến khi
unto	đến (ai)/(cái gì)
untold	vô hạn
untouched	đã không bị - ảnh hưởng, chạm
untreated	không được điều trị
unusual	bất thường
unusually	một cách bất thường
unutterable	không thể tả được
unuttered	bặt tiếng
unwashed	không có tắm rửa
unwieldy	chậm chạp
unwilling	đang không muốn
unwillingly	miễn cưỡng
unwittingly	một cách vô tình
unwonted	không mong muốn
up	lên
update	cập nhật
uphold	phát huy
upon	trên
upper	trên
uppermost	quan trọng hơn hết
upright	thẳng đứng
uprise	mọc
uproar	tiếng huyên náo
uproariously	một cách huyên náo
upset	buồn
upstanding	không thay đổi
upward	trở lên
urgent	khẩn cấp
urinary	chất thải
urology	khoa tiết niệu
us	chúng tôi/ta
use	sử dụng
used	sử dụng
useful	hữu ích
useless	vô ích
usher	người chỉ chỗ
usual	thông thường
usurp	chiếm đoạt
utensils	những đồ dùng
utility	tiện dụng
utter	hoàn toàn
uttered	đã thốt ra
uttering	thốt lên
utterly	một cách hoàn toàn
vacant	trống
vacant lot	lô trống
vacant seat	ghế trống
vacation	kỳ nghỉ
vague	mơ hồ
vaguely	mơ hồ
vain	vô hiệu, vô ích; rỗng tuếch, phù phiếm
vainly	tự phụ
valid	hợp lệ
valley	thung lũng
valleys	thung lũng
valor	lòng can đảm
value	giá trị
vanish	biến mất
vanity	tính kiêu căng
vapor	hơi
variable	thay đổi
variety	nhiều
various	khác nhau
vary	thay đổi
varying	khác nhau
vase	lọ
vast	bao la
vastness	tính mênh mông
vaunt	nhảy qua
veered	đổi hướng
vegetable	rau
vegetarian	ăn chay
vehicle	xe
veil	mạng che mặt
vein	tĩnh mạch
veins	những tĩnh mạch
velocity	vận tốc
vend	bán
vender	người bán hàng
venegeance	sự trả thù
venom	nọc độc
vent	lỗ thông hơi
venture	kinh doanh
ventured	đã mạo hiểm
veranda	hiên, hè
verbal	bằng lời nói
verdict	bản án
verify	xác minh
versatile	linh hoạt
vertical	thẳng đứng
very	rất
vest	áo khoác
veteran	kỳ cựu
veterinarian	bác sĩ thú y
vexation	sự làm bực mình, sự làm phật ý
vibrant	sôi động
vibrate	rung lên
vicarious	được uỷ nhiệm; làm thay người khác
vice president	phó giám đốc
vicious	xấu xa
victim	nạn nhân
victor	người chiến thắng
victory	chiến thắng
victual	cung cấp lương thực
view	xem, cảnh
views	quang cảnh
vigil	sự thức đêm
vigilant	cảnh giác
vigils	sự thức đêm; buổi cầu nguyện
vigor	nghị lực
vigorous	mạnh mẽ
vigorously	mạnh mẽ
vile	đê tiện
village	làng
villain	vai phản diện
vine-clad	nho phủ
vines	cây nho
violate	vi phạm
violently	bạo lực
virgin	còn mới nguyên
virility	sự nghị lực
virtue	đức tính, đạo đức; tư cách
visible	có thể nhìn thấy
vision	tầm nhìn
visions	tầm nhìn
visit	thăm
visitor	người truy cập
vital	sức sống; quan trọng
vitality	sức sống
vitamin	vi ta min
vivid	sinh động
vocabulary	từ vựng
vocal	đoạn xướng âm
voice	giọng nói
voiced	đã lên tiếng
voices	tiếng nói
void	làm mất hiệu lực
volatile	bay hơi
volcano	núi lửa
volcanoes	những núi lửa
volleyball	bóng chuyền
volume	khối lượng
voluntary	tự nguyện
volunteer	tình nguyện viên
vomit	nôn
voracious	tham ăn
vote	bỏ phiếu
vow	thề
vowel	nguyên âm
vulnerable	dễ bị làm hại
wage	tiền lương
wager	sự cá độ
wages	các tiền lương
wagged	đã ve vẩy
wagon	xe kéo
wailing	đang - than van, kêu khóc
wailings	những sự - than van, kêu khóc
waist	eo
wait	chờ đợi
waited	đã chờ đợi
waiting	chờ đợi
waive	từ bỏ
wake	đánh thức
waking	đang tỉnh dậy
walk	đi bộ
walked	đi
wall	tường
wallet	ví tiền
wallpaper	hình nền
walls	những bức tường
walnut	cây óc chó
wan	mệt mỏi
wander	đi lang thang
wandered	đã đi lang thang
wandering	lang thang
want	muốn
wanted	đã muốn
wantonness	sự nô đùa
war	chiến tranh
ward	phường
warehouse	kho hàng
warily	một cách thận trọng
warm	ấm áp
war-mad	điên máu chiến tranh 
warmed	đã ấm lên
warmer	ấm hơn
warmly	một cách nồng nhiệt
warn	cảnh báo
warning	đang cảnh báo
warrant	bảo đảm
warranty	bảo hành
wart	mụn có
wary	cảnh giác
was	đã là
wash	rửa
washed	rửa
washer	máy giặt
washes	rửa
washing	rửa
washing-pan	chảo dùng để rửa
waste	lãng phí
wastebasket	thùng rác
wasted	lãng phí
wasteland	đất hoang
watch	xem
watchdog	tổ chức giám sát
watched	đã xem
watchful	cẩn thận
watching	đang xem
watchman	nhân viên bảo vệ
watchword	khẩu hiệu
water	nước
watercourses	nguồn nước
waterfall	thác nước
waterfront	bến tàu
watering	sự dợn sóng
watermelon	dưa hấu
waterproof	không thấm nước
watershed	đường phân nước
waterway	kênh
watery	nhiều nước
watt	oát
wave	sóng
wavelength	bước sóng
waves	sóng
waving	đang vẫy tay chào
wax	sáp
waxed	đã đánh sáp
waxwork	tượng sáp
way	cách, đường
wayfarers	người đi bộ đi du lịch
ways	những cách
wayside	lề đường
we	chúng tôi
weak	yếu
weaken	làm yếu đi
weaker	yếu
weakly	suy nhược
weakness	điểm yếu
wealth	sự giàu có
wealthy	giàu có
weapon	vũ khí
wear	mặc
wearing	mặc
wearisome	chán ngắt
weary	mệt mỏi
wearying	mệt mỏi
weasel	con chồn
weather	thời tiết
weave	dệt
weazened	đã khô xác, nhăn nheo
web	mạng
webbed	đã màng
Weber	vê be
wed	cưới
wedge	mũi nhọn
wedges	nêm
Wednesday	Thứ Tư
weed	cỏ dại
weedy	um tùm cỏ dại
week	tuần
weekday	ngày trong tuần
weekend	cuối tuần
weeks	tuần
week's	của tuần
weeping	khóc vì tức
weigh	cân
weighed	đã cân nặng
weight	trọng lượng
weighty	quan trọng
weir	đập nước
weird	lạ
welcome	chào mừng
weld	mối hàn
welfare	phúc lợi
well	tốt; giếng nước
we'll	chúng tôi sẽ
went	đã đi
wept	đã khóc
were	đã là
west	hướng tây
westerly	hướng tây
western	phía tây
wet	đã ướt
we've	chúng tôi đã
whale	cá ông
whaling	đánh cá ông
wharf	cầu tàu
what	cái gì
whatever	bất cứ điều gì
what's	những gì
wheat	lúa mì
wheedlingly	một cách - vòi khéo, dỗ ngọt
wheel	bánh xe
wheelchair	xe lăn
wheel-dog	con chó gần bánh xe
wheeler	kẻ lái xe
when	khi
whenever	bất cứ khi nào
where	đâu
whereat	nơi
wherefore	tại sao
wherein	trong đó
whereupon	trên ấy
wherever	bất cứ nơi nào
whether	liệu, dù
which	mà, cái nào
whichever	tùy theo điều kiện nào
whiff	hơi rượu
while	trong khi
whim	không chừng
whimpered	đã rên rỉ
whimpering	rên rỉ
whine	than thở
whined	đã rên rỉ
whining	đang rên rỉ
whip	roi da
whipped	quất
whipping	đang quất roi
whips	roi
whipsawed	bị thất cơ lỡ vận
whirl	sự xoay lốc
whirled	đã xoay
whirlpool	xoáy nước
whirlwind	con trốt, cơn lốc
whisper	nói nhỏ
whispered	thì thầm
whistle	huýt sáo
whistling	huýt sáo
white	trắng
white-fanged	nanh trắng
white-hot	nóng trắng
whiteness	trắng hoàn toàn, (sự ngây thơ)
whittled	cắt xén
whittling	chuốt
who	ai
whoa	tiếng hô
whoever	bất cứ ai
whole	toàn bộ
wholesale	bán buôn
wholesome	lành mạnh
wholly	hoàn toàn
whom	ai
whoop	tiếng kêu
whore	con đĩ
whose	của ai
whoso	dầu là ai
why	tại sao
wick	bấc
wicket	cửa bán vé
wide	rộng
wide-eared	tai rộng
wide-eyed	mắt to
widespread	lan rộng
wide-spreading	rộng lây lan
widget	vật không tên
widow	góa phụ
width	chiều rộng
wielded	nắm giữ
wife	vợ
wig	tóc giả
wild	hoang dã, phóng đảng
wildcat	mèo hoang
wilder	hoang dã
wilderness	vùng hoang vu
wildfowl	gà rừng
wild-fowl	gà rừng
wildly	dại, hoang (ở) rừng; rối, lộn xộn, lung tung, điên cuồng, nhiệt liệt
wildness	sự hoang dã
wiliness	tính xão trá, tính quỷ quyệt
will	sẽ
willing	đang sẵn sàng
willow	cây liễu
willows	liễu
wily	xảo quyệt
win	giành chiến thắng
wince	nhăn mặt
wind	gió
wind instrument	nhạc khí hơi
winded	đã hết hơi
windfall	quả rụng
windmill	cối xay gió
window	cửa sổ
windows	những cửa sổ
winds	gió
windstorm	bão kèm theo gió
windup	lên dây
wine	rượu
winery	nhà máy sản xuất rượu
wing	cánh
winking	nháy mắt
winner's tip	tiền thưởng của người thắng cuộc
winter	mùa đông
winters	mùa đông
wintry	thuộc mùa đông
wipe	lau
wiped	bị xóa sổ
wiping	lau
wire	dây
wireless	không dây
wisdom	trí tuệ
wise	khôn ngoan
wish	chúc
wished	muốn
wistfully	tiếc nuối
witch	phù thủy
with	với
withdraw	thu hồi
withheld	khấu trừ, giữ lại
within	bên trong
without	ngoại trừ
withstanding	chịu được
witness	làm chứng
witnessed	chứng kiến
wives	vợ
woe	sự đau khổ
wolf	sói
wolf-cry	sói khóc
wolfish	như chó sói
wolflike	như chó sói
wolves	những con sói
woman	phụ nữ
womanhood	tính chất đàn bà, thời kỳ đã trưởng thành của người phụ nữ
womb	tử cung, lọt lòng
women	phụ nữ
won	đã thắng
wonder	phân vân
wondered	đã tự hỏi
wonderful	tuyệt vời
wont	thói quen
won't	sẽ không
wonted	là thói thường
wood	gổ
wooded	đã có nhiều cây cối
wooden	bằng gỗ
woodpeckers	chim gõ kiến
woods	những - miếng gổ, cái cây
woodwind	nhạc cụ hơi bằng gỗ
woody	thuộc về gô
wool	len
word	từ, chữ
words	từ
wore	mặc
work	làm việc
workbench	bàn thợ
workbook	sách hưỡng dẫn
worked	đã làm việc
worker	công nhân
working	làm việc
workload	khối lượng công việc
workman	người công nhân
workshop	hội thảo
workspace	nơi làm việc
world	thế giới
worm	sâu
wormed	chui vào, luồn vào
worn	mặc
worn-out	(mỏi) mòn
worried	lo lắng
worrisome	phiền phức
worry	lo lắng
worrying	đáng lo ngại
worse	tệ hơn
worship	tôn thờ
worshipful	đầy sự tôn kính
worst	tồi tệ nhất
worth	đáng giá trị
worthily	một cách xứng đáng
worthless	vô giá trị
worthy	xứng đáng
would	sẽ
wouldn't	sẽ không
wound	vết thương
wounded	đã bị thương
wounds	những vết thương
wound-stiffened	đã bị đầy thương tích
wow	ôi chao
wraith	sự hiện hình
wrangled	cãi nhau, cãi lộn; ẩu đả
wrap	bọc
wrapped	đã bọc
wrappings	những bao bì
wrath	cơn thịnh nộ
wreath	vòng hoa
wreck	xác tàu
wreckage	mảnh vụn
wrenched	giật
wrenching	đang vặn mạnh, xoắn; nỗi đau đớn khổ sở
wrest	cố giành lấy
wrestled	đã vật lộn
wrestling	đang vật lộn
wretched	không may
wriggle	vặn vẹo
wriggled	đã luồn lách
wrinkle	nếp nhăn
wrinkled	nhăn
wrist	cổ tay
wristband	miếng da bao cổ tay
wristwatch	đồng hồ đeo tay
writer	nhà văn
writhed	đã quằn quại
writhing	đang quằn quại
writing	viết
writing material	tài liệu viết
writing pad	sổ tay
written	viết
wrong	sai
wrote	đã viết
wrought	đã rèn (sắt); đã thuộc (da); đã bào kỹ (gỗ)
yacht	du thuyền
yam	khoai lang
yank	giật mạnh
yard	sân; một thước Anh
yards	những thước Anh
yarn	sợi
yawn	ngáp
yawned	đã ngáp
yawning	ngáp
yeah	vâng
year	năm
yearbook	niên giám
yearly	hàng năm
yearning	sự đau xót
yearnings	khao khát
years	những năm
yeast	men
yell	tiếng hét
yellow	màu vàng
yellowish	vàng nhạt
yelp	kêu ẳng ẳng
yelped	đã kêu ẳng ẳng
yelping	đang kêu ẳng ẳng
yelps	kêu ăng ẳng
Yen	yên
yep	vâng
yes	vâng
yesterday	hôm qua
yet	nhưng
yield	năng suất
yin	âm
yodel	đổi giọng trầm sang giọng kim
yoga	dô ga
yoke	kẹp
yokel	kẻ quê mùa
you	anh
you'd	(bạn) sẽ muốn
young	trẻ
younger	trẻ hơn
youngster	cầu thủ trẻ
your	của anh
you're	(bạn) đang
You're welcome	không có chi
yours	của bạn
youth	trẻ, thanh niên
you've	anh/bạn đã
zeal	nhiệt huyết
zebra	ngựa vằn
zenith	thiên đỉnh
zero	số không
zest	sự vui vẻ
zigzag	hình chữ chi
zinc	kẽm
zombie	thây ma sống lại
zone	khu vực
zoo	vườn thú
zoology	động vật học
zoom	phóng
zucchini	bí đao
qua	why not
Trong	OK in English
