50 dặm	fifty-mile
à	expression Oh!, by the way
ạ	polite expression to someone superior
à 	yes (expression)
á thần	demigod
ác	evil
ác 	evil
ác liệt	fierce
ác tâm	malice
ác tính	malignant
a-cri-lích	acrylic
ai	who, (unknown, uncertain)
ái	exclamation of pain or surprise
ai cũng có gia tộc	everyone has family
ai nấy 	everyone
ám	possess, darken
âm	yin, minus
ấm	warm
ầm	loud
ẩm	moist, humid
ám 	possess
ầm ầm	rumble
ấm áp	warm
ám chỉ	allude
ảm đạm	bleak, gloomy, dreary
âm điệu	tone, melody
ám muội	shady, dubious, underhand, sinister
âm mưu	conspire, plot, conspiracy
âm nhạc	music(al)
ám sát	assassinate
âm thanh	sound
âm u	dim
ẩm ướt	damp, humid
amip	amoeba
amoniac	ammonia
ampe	ampere
án	a (legal) sentence
ân	grace, favour
ăn	eat
ấn	publication, stamp
ẩn	hide
ấn 	to press; an official stamp
ăn cắp	steal
ăn chay	vegetarian
ăn cơm	dine; eat rice
ấn Độ	India
ăn được	edible
ăn kiêng	dietary, dietetic, dieting
ăn mày	beggar
ăn mòn	corrosion
ăn năn	repent, penance
ẩn náu	to hide
ăn ở	eat and live (at, with)
ăn quá nhiều	overeat, eat too much
an toàn	safe, secure
án tử hình	death penalty
ấn tượng	impression
an ủi	comfort, console
ăn vô độ	binge
áng nắng ban ngày	daylight
anh	elder brother/male, 1st 2nd person (reference to male > he)
ánh	light
ảnh 	photo, picture; he
anh (em) họ	cousin
anh ấy	he/him (older male level)
anh ấy 	he, him (older male level)
anh bạn	fellow
anh cúi 	you/he bend(s)  (older male level)
anh đã	you've  (older male level)
anh dâu	older brother in law (wife side)
anh em	brothers, elder brother of mine(younger level)
ánh hồng	afterglow
anh hùng	hero(ic)
ảnh hưởng	affect, influence
ảnh hưởng bởi	affected by
ảnh hưởng đến	affect
ánh mắt	glance, eye reflection
ánh nến	candlelight
anh nhìn 	he/you looks  (older male level)
anh rể	older brother in law (husband side)
ánh sáng	light
anh ta	him
ánh trăng	moonlight, moonshine
anh viết 	he/you write  (older male level)
ao	pond
áo	shirt
áo 	shirt, upper cloth wear
áo choàng	robe, cloak
ao hồ	lake
áo khoác	coat, vest
áo len	sweater
áo mưa	raincoat
ảo thuật	magic
ảo tưởng	delusion
ao ước	crave
áp	pressure
ấp	brood
áp bức 	oppress
áp dụng	apply
áp lực	pressure
áp suất không khí	air pressure
áp xe	abscess
át	to drown out (noise)
át lát	atlas
ấu	child, youth
ấu chấm câu	punctuation mark
a-xê-tát	acetate
a-xê-ti-len	acetylene
a-xê-tôn	acetone
axit	acid
ấy	that
ấy 	that
ba	three, father 
bà	grandmother, she, woman (pronoun 1st, 2nd singular)
bã	residue
bả	bane; she(older woman)
bá chủ	master of dominion
bà cố	great grandmother
bà già	old woman
ba lần	three times
ba lô đeo vai	backpack
ba mươi	thirty
bà ngoại	grandmother (mother'side)
bà nội	grandmother (father'side)
bá tước	earl
bác	uncle (father or mother's older brother/sister)
bấc	wick
bắc	north
bạc	silver
bậc	echelon
bác bỏ	demurrer
Bắc Cực	arctic
bác gái	aunt (older sister of father or mother)
bác sĩ	doctor, physician
bác sĩ chó 	dog-doctor
bác sĩ da liễu	dermatologist
bác sĩ nhi khoa	pediatrician
bác sĩ thú y	veterinarian
bách	100, all (indirect meaning)
bách khoa toàn thư	encyclopedia
bạch tuộc	octopus
bài	article, lesson, post
bãi	bank, expanse, ground, field
bại 	fail(ure)
bãi biển	beach
bãi bỏ	abolition
bãi chọi gà	cockpit
bãi cỏ	lawn
bải cỏ	meadow
bài giảng	lecture
bài hát	song
bài hát ca ngợi	anthem
bài hát mừng	carol
bài học	lesson
bài luận	essay
bài phát biểu	speech
bài tập về nhà	homework
bài thơ	poem
bài thuyết giáo	sermon
bài viết	article
bám	cling
băm	to chop, mince
bẩm	congenital; to refer (to higher level) before title: "dear" sir
bám chặt vào	attach firmly to
bẩm sinh	congenital
bán	sell
bàn	desk, table
bần	poverty
bắn	shoot
bản	a composition, copy (classifier)
bẩn	dirty
bạn	friend, you (friend level)
bận	busy, an instance, an incidence, one time 
ban 	department
bản án	verdict
bán buôn	wholesale
bán cầu	hemisphere
bàn chải đánh răng	tooth brush
bàn chân	foot
bản chất	essence
bạn chí thân	crony
ban cho	give to, grant
ban công	balcony
bán đảo	peninsula
ban đầu	initial
bán đấu giá	auction
ban đêm	night time
bản địa	native
bản đồ	map
ban giám đốc	directorate
bán hàng	sales
bạn học	classmate
bản kế hoạch	blueprint
bản khai	affidavit
băn khoăn	In a divided mind
băn khoăn 	anxious, divided mind
bán kính	radius
bán lẻ	retail
bản lề	hinge
bản năng	instinct
ban ngày	daytime
bạn nghề	mate
ban nhạc	band
ban phước	bless
bận rộn	busy
bản sao	copy
bản sao chép	copy
ban sơ	primitive
bàn tay	hand, palm
bản thân	self
bạn thân	buddy
bản thiết kế	blueprint
bàn thờ	altar
bàn thợ	workbench
bản trích yếu	compendium
bán vé	ticket sale
bản xứ	aboriginal
báng	butt of rifle/gun
băng	ice, bandage, tape
bằng	by, equal
bảng	board, table, list, roll
bằng 	by, equal
bảng 	board
bằng biểu đồ	diagrammatic
báng bố	desecrate
băng cát sét	cassette
bằng chứng	evidence, proof
băng đảng	gang
bằng đất	earthen
bảng đen	blackboard
băng giá	frost
bằng gỗ	wooden
bằng lời nói	verbal
bằng lòng	acquiesce
bằng miệng	oral
bằng nhau	equal
băng qua	crossing, pass
bằng tay	manual
bảng xếp hạng	billboard
banh	ball
bánh	cake; wheel
bánh 	cake, bakery
bánh bao	white bun cake
bánh mì	bread
bánh ngọt	pastry
bánh quy	cookie
bánh răng	gear
bánh xe	wheel
bao	sack, bag
báo	report, newspaper
bào	of cell; to shave
bão	storm
bảo	tell, order
bạo	violent, bold
bạo 	violence, bold
bao bì	wrapping
báo cáo	report
báo chí	press
báo cho biết	apprise
bào chữa	plead
bảo đảm	warrant
báo động	alarm, alert
bao giờ	ever
bao gồm	involve
bảo hành	warranty
bảo hiểm	insurance
bão hòa	saturate
bão kèm theo gió	windstorm
bao la	vast
bảo lãnh	guarantee
bào mòn	abrasive
báo mộng	reported in dream
bào ngư	abalone
bảo quản	preserve
bảo tàng	protective treasure, museum
bảo tồn	conserve
báo tranh chuyện vui	comic
bão tuyết	blizzard
bao vây	surround
bảo vệ	guard, protect
bắp	corn; muscle
bắp cải	cabbage
ba-ri	barium
bát	bowl
bất	any
bắt	apprehend, catch
bật	to pluck, recoil, rebound
bật 	(to)turn on, switch
bắt buộc	compel, compulsive
bất cẩn	careless
bất chấp	defy
bất chợt	casual
bắt chước	imitate, mimic
bắt cóc	abduct, kidnap
bất công	unfair
bất cứ ai	whoever, anybody, anyone
bất cứ cách nào	anyway, whichever way
bất cứ cái gì	anything
bất cứ điều gì	whatever, anything
bất cứ khi nào	whenever
bất cứ lúc nào	whenever
bất cứ nơi đâu	anyplace
bất cứ nơi nào	wherever
bất đắc dĩ	Unavoidable, reluctant, grudging
bắt đầu	start, begin, beginning
bật dậy 	turn up
bất động	motionless
bất động sản	real estate
bắt giữ	arrest, capture
bất hợp pháp	illegal
bất khả chiến bại	invincible
bất kỳ	any
bật lại	rebound
bất lợi	adverse
bất lực	incompetent, helpless, powerless
bắt nạt	bully
bất ngờ	surprise
bắt tay	handshake
bất thường	extraordinary, abnormal, unusual
bất tỉnh	unconscious
bất tử	deathless, immortal
bầu	to vote; a gourd; ovary
bầu cử	election
bầu không khí	atmosphere
bầu trời	sky
bay	fly
bày	presented
bây	now
bấy	then; crush pulpy
bầy	herd
bẫy	trap
bảy	seven
bẩy	seven
bậy	rubbish, wrong
bầy đàn	flock
bây giờ	now
bay hơi	evaporate
bảy mươi	seventy
bé	little, child
bè	friends, a raft
bế	carry (infant) in both arms
bề	surface, side
bẻ	break
bể	water tank; to break
bệ	platform
bê 	baby cow, to carry
bề 	surface, side
bể cá	aquarium
bề mặt	surface
bề ngoài	appearance
bén	sharp
bèn	so then
bên	side
bến	terminals, landing stage
bền	durable
bện	braid
bến 	terminals, port
bến cảng	harbor
bên cạnh	beside
bên dưới	beneath
bên kháng cáo	appellant
bẽn lẽn	bashful
bén lửa	glazed, catch fire
bên ngoài	external, outside
bên phải	right side
bên sườn	flank
bến tàu	pier, port
bên thua	losing side
bên trên	above
bên trong	within, inside
bênh	defend
bềnh	floating
bệnh	ill
bệnh lỵ	dysentery
bệnh nhân	patient
bệnh suyễn	asthma
bệnh tiểu đường	diabetes
bệnh tự kỷ	autism
bệnh viêm ruột thừa	appendicitis
bệnh viện	hospital
beo	leopard
béo	blubber, fat, obese
bếp	kitchen
bếp 	kitchen
bét	last in standing
bết	to smear; stick to, bad, inferior
bi	bi
bì	Packaging
bỉ	persistence
bị	is (affected) by
bi ai	mournful
bí ẩn	mystery
bị ăn cắp	(to be) stolen
bị ảnh hưởng	(to be) affected
bị áp bức	(to be) oppressed
bị bắn	(to be) shot
bị bắn phá	(to be) bombarded
bị bão	(to be) stormed
bị bao bọc	(to be) enveloped
bị bao gồm	(to be) included
bị bao quanh	(to be) surrounded
bị bắt	(to be) caught
bị bắt buộc	(to be) compelled
bị bắt cóc	(to be) kidnapped
bị bắt giữ	(to be) captive
bị bất ngờ	(to be) unexpected
bị bắt vít	(to be) bolted
bị bệnh khờ	(to be) retarded
bị biến mất	(to be) disappeared
bị bỏ rơi	(to be) left behind
bị bọc	(to be) wrapped
bị bối rối	(to be) puzzled
bị bùng phát	(to be) boomed
bị buộc	(to be) forced
bị buộc dây 	(to be) leashed
bị cai trị	(to be) ruled
bị cảm thấy	(to be) felt
bị cầm tù	(to be) imprisoned
bị cắn	(to be) bit (bite)
bị cắn nhẹ	(to be) nipped
bị can thiệp	(to be) interfered
bị căng thẳng	(to be) strained
bị cắt giảm	(to be) slashed, cut, reduce
bị càu nhàu	(to be) grumbled, complained
bị chai	(to be) hardened, callous
bị chậm phát triển	(to be) retarded
bị chán	(to be) bored
bị cháy sém	(to be) fire-scorched
bị chế giễu	(to be) taunted
bị chết	(to be) dead
bị chết đói	(to be) famished, starved
bị chết đuối	(to be) drowned
bị chiếm	(to be) occupied
bị chìm	(to be) sunken
bị chở bằng xe tải	(to be) transported by truck
bị chờ đợi	(to be) waited
bị choáng váng	(to be) dazed
bị chọc	(to be) poked
bị chơi	(to be) played
bị chôn	(to be) buried
bị chọn	(to be) selected
bị chôn vùi	(to be) buried
bị chuyển	(to be) shifted
bị chuyên chở	(to be) freighted
bị chuyển dời	(to be) moved
bị chuyển đối	(to be) transformed, changed
bị cọ xát	(to be) rubbed
bị cong	(to be) bent
bị cười	(to be) laughed
bị cuộn	(to be) rolled
bị cuốn lên	(to be) reeled, curled
bị cướp	(to be) robbed
bị đá ra	(to be) bucked, kicked out
bị đâm sầm	(to be) crashed
bị dẫn	(to be) led
bị đánh	(to be) beaten, struck
bị đánh dấu	(to be) marked
bị đánh giá thấp	(to be) undervalued
bị đánh sáp	(to be) waxed
bị đánh thức	(to be) roused
bí đao	(to be) zucchini
bị đập	(to be) pounded, clubbed
bị đập nát	(to be) smashed
bị đặt	(to be) placed
bị đau đớn	(to be) lacerated, in pain
bị đau khố	(to be) suffered
bị đẩy	(to be) propelled, pushed
bị đầy chiến sẹo	(to be) battle-scarred
bị đầy thương tích	(to be) wound-stiffened
bị đe dọa	(to be) threatened
bị di dời	(to be) displaced
bị đi khập khiễng	(to be) limped
bị đi theo	(to be) followed
bị điên rồ	(to be) crazed
bí đỏ	(to be) pumpkin
bị đố	(to be) shed, pour
bị đối mặt	(to be) faced
bị đối xử	(to be) treated
bị đốm	(to be) flecked
bị đóng	(to be) closed, shut
bị động	passive
bị đóng dấu	(to be) stamped
bị đóng gói	(to be) packed
bị đông lạnh	(to be) frozen
bị đóng yên	(to be) harnessed
bị đớp	(to be) snapped, bitten
bị đua	(to be) raced
bị đưa ra	(to be) launched
bị đụng	(to be) crashed
bị ép	(to be) pressed, pressure to
bị gắn chặt	(to be) fastened
bị gặp phải	(to be) encountered
bị gấp rút	(to be) hurried
bị gây ra	(to be) caused
bị gãy răng rắc	(to be) snapped
bị ghét	(to be) hated
bị ghi điểm số	(to be) scored
bị giậm chân	(to be) stamped
bị giẫm xéo	(to be) trampled
bị giảm xuống	(to be) plunged
bị gián đoạn	(to be) disrupted
bị giật	(to be) jerked
bị giấu	(to be) hid
bị giết	(to be) killed
bị giới hạn	(to be) confined
bị giữ	(to be) held, kept
bị gõ	(to be) knocked
bị gọi	(to be) called
bị gọi là	(to be) called
bị gửi	(to be) sent
bị hạ xuống	(to be) lowered
bị hết hơi	(to be) winded
bị hỏi	(to be) asked
bị hỏng	(to be) broken, not working
bị hy sinh	(to be) sacrificed
bị kéo	(to be) dragged, pulled, towed
bị kéo dài	(to be) stretched
bị kéo lên	(to be) hoisted
bị kéo lết phết	(to be) draggled
bị kết thúc	(to be) finished
bị khảo sát	(to be) surveyed
bị khó chịu	(to be) annoyed
bị không ai để ý đến	(to be) unheeded
bị khuấy	(to be) stirred
bi kịch 	(to be) tragedy, sad drama
bi kịch lịch sử	(to be) historic drama
bị kích thích	(to be) aroused
bị kiểm tra	(to be) checked, examined
bị kiệt sức	(to be) exhausted
bị lắc	(to be) shaken
bị làm nát	(to be) crunched
bị làm ngạt thở	(to be) smothered
bị làm tê liệt	(to be) crippled
bị làm việc	(to be) worked
bị làm việc vất vả	(to be) toiled
bị lao vào	(to be) rushed in
bị lao xuống	(to be) plunged
bị lặp đi lặp lại	(to be) repeated
bị lật đố	(to be) overthrown
bị lật úp	(to be) capsized
bị lấy	(to be) taken
bị lấy lại	(to be) regained
bị leo lên	(to be) climbed
bị lo lắng	(to be) rattled
bị loại bỏ	(to be) discarded
bị loạng choạng	(to be) staggered
bị lôi	(to be) hauled
bị lừa	(to be) fooled
bị ma ám	(to be) possessed
bí mật	(to be) secret, confidential
bị mở ra	(to be) opened
bị mô tả	(to be) described
bị nài xin	(to be) pleaded
bị nắm chặt	(to be) gripped
bị nản lòng	(to be) daunted
bị nâng lên	(to be) raised
bị ném	(to be) hurled, thrown
bị nện	(to be) pounded
bị ngạc nhiên	(to be) surprised
bị ngập lụt	(to be) deluged
bị nghẹn thở	(to be) choked
bị nghiêng	(to be) slanted, inclined
bị ngừng	(to be) ceased
bị nguyền rủa	(to be) cursed
bị nhận ra	(to be) realized, identified
bị nhìn	(to be) looked
bị nửa choáng váng	(to be) half-stunned
bị nuốt chửng	(to be) devoured
bị nuốt ực	(to be) gulped
bị nứt	(to be) cracked
bị ở tình trạng	(to be) fared
bị oằn	(to be) buckled
bị oằn xuống	(to be) sagged
bị ốm	(to be) ill
bị phá hủy	(to be) destroyed
bị phá vỡ	(to be) broken
bị phản bội	(to be) betrayed
bị phản đối	(to be) countered
bị phân phối	(to be) distributed
bị phát hiện	(to be) discovered
bị phớt lờ	(to be) ignored
bị phủ	(to be) covered
bị phủ lên	(to be) draped
bị phủ tráng	(to be) coated
bị phun	(to be) sprayed
bi quan	pessimistic
bị quản lý	(to be) managed
bị quằn quại	(to be) squirmed
bị quan sát	(to be) observed
bị quan tâm	(to be) cared, concerned
bị quạt	(to be) fanned
bị quay	(to be) turned
bị quay lên	(to be) reeled
bị quên	(to be) forgotten
bị quét	(to be) swept
bị quì	(to be) squatted
bị ra dấu hiệu	(to be) signaled
bị ra lệnh	(to be) commanded, ordered
bị rạch	(to be) slashed
bị rối	(to be) tangled
bị rơi	(to be) crashed, fallen
bị run lên	(to be) quivered
bị run rẩy	(to be) trembled
bị rùng mình	(to be) shivered
bị rút ra	(to be) pulled out
bị sai lầm	(to be) blundered
bị siết chặt	(to be) clasped
bị sợ	(to be) feared
bị sợ hãi	(to be) terrified
bị so sánh	(to be) compared
bị sủa	(to be) barked
bị sưng lên	(to be) swollen
bị tả tơi	(to be) ragged
bị tách rời	(to be) seperated
bị tan băng	(to be) thawed
bị tấn công	(to be) charged, attacked
bị tăng	(to be) increased
bị tăng gấp đôi	(to be) doubled
bị táp	(to be) snapped
bị té	(to be) fell
bị té nhào	(to be) tumbled
bị thách thức	(to be) defied
bị tháo ra	(to be) unfastened
bị thất bại	(to be) failed
bị thắt chặt	(to be) tightened
bị thấy	(to be) seen
bị thay đối	(to be) changed
bị thay thế	(to be) replaced
bị thêm	(to be) added
bị theo dõi	(to be) stalked
bị thối	(to be) blown
bị thông qua	(to be) passed
bị thu	(to be) collected
bị thu hút	(to be) attracted
bị thúc đẩy	(to be) spurred, pushed
bị thương	(to be) injured
bị tìm thấy	(to be) found
bị tính phí	(to be) charged
bị tốn thất	(to be) suffered
bị trả đũa	(to be) retaliated
bị trần truồng	(to be) naked
bị tránh	(to be) avoided
bị tránh xa	(to be) shunned
bị trao đối	(to be) exchanged
bị treo	(to be) hung
bị trì hoãn	(to be) delayed
bị trở thành	(to be) became
bị trở thành mềm	(to be) softened
bị trôi qua	(to be) lapsed
bị trốn	(to be) escaped
bị trốn việc	(to be) shirked
bị trong tình trạng âm ỉ	(to be) smothered
bị tru	(to be) howled
bị trữ	(to be) reserved
bị trừng phạt	(to be) punished
bị từ chối	(to be) refused
bị ướt	(to be) wet
bị vật lộn	(to be) wrestled
bị vò nát	(to be) crumpled
bị vượt qua	(to be) crossed, passed
bị xâm nhập	(to be) pervaded
bị xấu hố	(to be) ashamed
bị xảy ra	(to be) happened
bị xé	(to be) ripped
bị xé rách	(to be) torn
bị xem	(to be) watched
bị xén	(to be) clipped
bị xoắn	(to be) twisted
bị xoay	(to be) whirled
bị xông vô	(to be) stormed in
bị xử lý	(to be) dealt
bị xung đột	(to be) clashed
bị yêu cầu	(to be) demanded, required
bia	beer
bi-a	billiard
bìa	cover
bịa	fabricated
bia đen	porter
biếc	bluish green
biên	edge, to write
biến	change, transform
biển	marine, sea
biến chất 	transform, metamorphic
biên dịch viên	translator
biên độ	amplitude
biến đối	convert
biên giới	boundary, border
biến hình	transform
biên lai	receipt
biến mất	vanish
biện pháp	remedy, solution
biên soạn	compile
biển tên	name plate
biếng	lazy
biếng 	lazy
biết	know(ing), aware
biệt	special, unique; disappear
biệt danh	nickname
biệt thự	mansion
biết vâng lời	dutiful, obedient
biếu	to gift
biểu	expression
biểu 	tell (order)
biểu đồ	chart
biểu hiện	express, display signs/symtoms
biểu thị	denote
biểu tình	protest, strike
bỉm	diaper
binh	soldiers
bình	canister, pitcher, vase
bịnh	sick
binh chủng thiết giáp	armor
bình đẳng	equal
bình đun nước	kettle
bình luận	comment
bình minh	dawn, daybreak
bình thường	ordinary, normal
bình tĩnh	calm, composed
bịt	muzzle
bịt kín	fully cover
bịt mắt	blindfold
bó	bunch, bundle
bò	cow
bố	father
bồ	romantic friend, lover
bỏ	to quit leave, drop off
bơ	butter
bọ	bug
bờ	shore, bank
bộ	by foot, appearance
bố 	father, dad
bờ 	shore
bợ 	to lowly kiss up
bỏ bê	neglect
bờ biển	coast, shore
bò cái	cow
bọ cánh cứng	beetle
bố chồng	father in law
bồ công anh	dandelion
bộ da	skin
bỏ đạo	apostate
bỏ đi	abandon
bộ đồ ăn	dinnerware
bộ đồ ngủ	pajamas
bò đực	bull
bó hoa	bouquet
bộ khuếch đại	amplifier
bộ lạc	tribe
bỏ lỡ	miss
bộ lọc	filter
bỏ mạng	perish
bố ngữ	adjunct
bố nhiệm	designate, appoint
bộ phận	part
bỏ phiếu	vote
bỏ phiếu trắng	abstention
bỏ qua	forego, skip
bò rừng	bison
bơ sữa	dairy
bố sung	complement
bờ vai	shoulder
bố vợ	father in law
bờ vực	brink
bộ xương	skeleton
bộ yên cương	harness
bóc	peeled
bốc	to pick up in one's hands; prepare medicine compound 
bọc	wrap
bộc	reveal
bốc lên	exhale, fume
bói	fortune telling
bôi	smear
bồi	waiter; to strenthen
bơi	swim
bới	dig by raking
bời	by the ravages of
bội	multifold, greater
bởi	by, because
bối cảnh	background
bối rối	confused
bồi thẩm đoàn	jury
bồi thường	compensate
bởi vì	because
bom	bomb
bợm	punk, jerk
bờm 	mane
bơm phồng	inflate
bón	fertilize; constipation
bốn	four
bồn	tub
bọn	gang, band, group
bộn	crowded with, encumbered with; quite in number
bọn 	bunch, gang
bốn mươi	forty
bồn rửa	sink
bồn tắm	tub
bóng	shadows, reflection, impression , shade
bông	flower, flake
bống	goby fish
bồng	carry in one's arms
bỗng	suddenly
bỏng	burns
bong 	peel off
bóng bay	balloon
bong bóng	bubble, balloon
bồng bột	vulnerable
bóng chày	baseball, cricket
bóng chuyền	volleyball
bóng đá	football
bọng đái	bladder
bóng đèn	bulb
bóng gió	allusive
bóng rố	basketball
bông tai	earring
bóng tối	shadow, darkness
boong	deck
bóp	squeeze
bóp 	squeeze, tighten
bóp cố	throttle
bóp méo	distort
bốt	boots
bớt	reduce
bột	batter, flour, powder
bọt 	foam
bột nhào	dough
bù	compensate, repay for
bu 	gather
bù nhìn	scarecrow
búa	hammer, axe
bừa	to rake; being rash, easy-going
bữa	meal; a session of 
bữa 	session
bữa ăn	meal
bữa ăn nhẹ	snack
bữa ăn sáng	breakfast
bữa ăn tối	dinner, supper
bữa ăn trưa	lunch
bùa hộ mệnh	amulet
bức	picture (classifier); to force
bực	upset, annoyed
bực mình	annoyed
bức tường	wall
bụi	dust, dusty
bụi rậm	bush, undergrowth
bulô	birch
bu-lông	bolt
bumơrang	boomerang
bùn	mud
bung	expand as a spring
bủng	limp, flabby, sallow
bưng	mangrove swamp; to carry, to cup in one's hand
bụng	belly, abdomen
bừng	flare brightly, to turn suddenly red hot; to wake suddenly
bùng nố	boom
bùng phát	outbreak
buộc	fasten
bước	walk, step
buộc 	tie, obligate
bước chân	footstep
buộc tội	accuse
buối	session, (unique classifier for time related session) 
buối chiều	afternoon
buối hòa nhạc	concert
buối họp kín	secret meeting
buối sáng	morning
buối tối	evening
buồm	sail
bươm	shreds, tattered
bướm	butterfly
bướm đêm	moth
buôn	to sell, to trade
buồn	sad, upset
buồn bã	sullen
buồn chán	doldrum
buôn lậu	smuggle
buồn rầu	depressing
buông	let go, let down, to drop
búp	sprout
búp bê	doll
bút	writing device (pen, pencil..)
bút 	pen
bút chì	pencil
bưu điện	post office
bưu kiện	parcel of good
bưu kiện 	parcels
bưu phẩm gửi bằng đường hành không	airmail
bưu thiếp	postcard
ca	chant, sing
cá	fish
cà	tomato
cả	all, entire
cá chép	carp
cả cuộc đời	lifetime
cả hai	both
cá heo	dolphin
cá hồi	salmon
cá mập	shark
ca ngợi	acclaim, praise
cá ngừ	tuna
cả nhà	whole house/family
cá nhân	individual, personal
cá nóc	blowfish
cá ông	whale
cà rốt	carrot
cá sấu	crocodile, alligator
ca sỹ	singer
cá thu	mackerel
cá trê	catfish
ca tụng	praise repeatedly
cá tuyết	cod
cá vàng	goldfish
cá voi 	whale
các	plural (indicator), multiple, more than one
các anh em	the brothers
các bà mẹ	the mothers
các bon	carbon
các chân	the legs
các đầu gối	the knees
các loại	the kinds, types
các mảnh vá	the patches
các mỏ	the mines
các nước 	the juices
cách	way, method; distance from
cách chức	depose
cách diễn tả	diction
cách lập luận	argumentation
cách ly	isolate
cách này hay cách khác	somehow
cách ngôn	aphorism
cách nhiệt	insulation
cách phát âm rõ ràng	articulatory
cách thức	mode
cai	rule, jailkeeper, warden; to give up
cái	the (for things), unique classifier for objects
cãi	argue, dispute
cải	cabbage; to reform
cái ác	the evil
cái áo choàng	robe
cái bát	the bowl
cái bồn chứa	tank
cải cách	modernize, change, reform
cái cân	weighing scale
cái cặp	bag, briefcase
cái cầu	bridge
cái cây	tree
cái chắn bùn	the dashboard
cái chết	death
cái chốt	detent
cái chuồng	stable, kennel
cái cố họng	throat
cái cưa	the saw
cái cửa	door
cài đặt	install
cái đinh	the nail
cái đó	that
cái đồ đựng	the container
cái đói	the starvation, hunger
cái đục	the chisel
cái dùi	the awl
cái đùi	thigh
cái đuôi	tail
cái gạt tàn	the ashtray
cái gáy	the scruff
cái gậy	walking stick
cái gì	what
cái giá	the rack
cái hàm răng	jaw
cái hông	hip
cái kén	cocoon
cái kéo	the scissor
cái kẹp	the clamp, the clip
cái kìm	the nip
cãi lộn	altercate
cái lưỡi	tongue
cái mái che	the roof
cái móc	the hook
cái môi	lips
cái nạng	the crutch
cái nào	which
cái này	this
cãi nhau	bicker, quarrel
cải nhau	spat, argue
cái nhìn thoáng qua	glimpse
cái nôi	the cradle
cái phanh	the brake
cái phễu	the funnel
cái răng	tooth
cái ruy băng	ribbon
cái song chắn	bar
cải thiện	improve
cái thùng gố	crate
cái tố	nest
cái tôi	the ego
cải trang	disguise
cai trị	reign, govern
cái ví	purse, wallet
cái xẻng	scoop
cái xô	pail, bucket
cái xương	bone
cái xương sườn	rib
cái yếm	bib
cam	orange color; orange fruit
cám	bran
câm	dumb
cấm	ban, forbid, prohibit
cầm	hold 
cắm	plug
cằm	chin
cảm	feel, feeling a cold
cặm	to fix; to plant
cắm 	plug, to stake/pitch
cắm cột	pole
cam đoan	assure
cảm động	pathetic
cảm giác	sensation
cảm giác bất an	disquietude
cầm giữ	hold
cảm hứng	inspiration
cam kết	commit, pledge
cảm ơn	thank
cảm ơn bạn	thank you
cảm thấy	feel
cầm tù	hold in prison, imprison
cảm xúc	feeling, emotion
cán	handle, a staff(stick); to roll into thin layers
càn	raid, to mop up
cân	scale, weigh
cần	need
cắn	bite
cản	to prevent, to stop, to bar
cẩn	to inlay (decoration)
cạn	shallow
cặn bã	scum
căn bản	basal
cân bằng	balance
cán chổi	broomstick
căn cứ	base (on)
can đảm	bravery, courage
căn nhà nhỏ	cottages
cằn nhằn 	grumbling
cắn nhẹ	nip
cẩn thận	careful
cận thị	nearsighted
can thiệp	interfere, meddle
cần thiết	necessary
cắn xé	mangled
cáng	stretcher
càng	more
căng	strained
cảng	dock, port
cẳng	shank, leg
càng 	the more…(verb); claw
căng 	strained, stretch
cảng biển	seaport
càng nhiều	the more
căng ra	stretch
căng thẳng 	tense, stress, stretch straight
căng thẳng cao độ	high-strung, intense
căng tin	cafeteria
canh	broth
cánh	wing
cành	branch
cảnh	scene
cạnh	edge, next to
cảnh 	scene, sight
cạnh 	edge, next to
cảnh báo	warn, caution, alert
cành cây	branch of tree
cạnh giường	bedside
cánh hoa	petal
cảnh quan	sight, landscape
cánh quạt 	propeller
cánh quạt chân vịt 	propeller blades
cảnh sát	sheriff, policeman
canh tác	cultivate
cánh tay	arm
cạnh tranh	compete, competitive
cạnh, rìa, viền	edge
canxi	calcium
cao	high, tall
cào	scratched, rake
cạo	scrape
cao cấp	senior
cao cấp hơn	superior
cao điểm	peak
cáo lỗi	apologize
cạo râu	shave
cao su	rubber
cao thượng	noble
cấp	level
cắp	theft
cập	to land, to draw up alongside
cặp	pair
cấp 	level
cập 	pull next to
cấp cho	provide to
cập nhật	update, gather information
cặp tài liệu	briefcase
cấp tiến	radical
cấp tính	acute
cặp vợ chồng	couple
cặp vợ chồng kết hôn	married couple
Carbohydrat	carbohydrate
cát	sand
cất	distilled; put away
cắt	cut
cắt bao quy đầu	circumcise
cắt bỏ	ablate
cất cánh	take off
cắt cụt	amputate
cắt giảm	slash off, reduce
cáu	angry
câu	to fish; a sentence; a dove
cấu	to claw, nip
cầu	plead, globe; a bridge
cậu	uncle (mother's younger brother)
câu 	sentence
câu chuyện	tale
cau có	frown, scowl
câu đố	puzzle
câu hỏi	question
cáu kỉnh	irritable
câu lạc bộ	club
cau mày	frown
cầu nguyện	pray
càu nhàu 	grumble
cầu tàu	wharf
cầu thang	stair
câu trả lời	answer
cay	spicy
cáy	fiddler crab; timid (as a rabbit)
cày	plow
cây	tree, plant, (unique classifier of stick like object)
cấy	transplant; grow rice, to farm, to culture
cầy	dog-meat
cậy	dependable
cay 	hot, spicy
cây ăn quả	fruit tree
cây ăn sâu bọ	carnivore
cầy cấy	farming
cây cung	bow
cay đắng	spicy and bitter, negatively bitter feeling
cây dương	poplar
cây dương tía	alder
cây gậy	the stick
cây giáo	pike
cây húng quế	basil
cây liễu	willow
cây ngải đắng	absinthe
cây ngưu bàng	burdock
cây nhung tuyết	edelweiss
cây ô rô	acanthus
cây óc chó	walnut
cây thông	pine
cây thủy tiên hoa vàng	daffodil
cây tre	bamboo
cây trồng	crop
cây xương rồng	cactus
cay, nóng	hot
cha	father
chà	rub, scrape, expression: Oh, well!
chả	grilled chopped meat/fish/shrimp
chạ	promiscuous
cha đỡ đầu	godfather
cha mẹ 	father mother, parents
cha tôi 	my father
chắc	probably(with uncertainty when in front of adjective), sure(when at the end)
chắc chắn	sure
chai	bottle
chái	lean-to, hip of roof
chải	comb, brush
châm	prick
chăm	diligent, care for
chấm	a dot; to grade
chạm	touch, carve, sculpt
chậm	slow
chăm 	take care, diligent
chạm 	touch
châm biếm	satire
chằm chằm	glare, intently
chậm chạp	sluggish
chăm chú	intent focus
chấm dứt	terminate
chậm hơn	slower
châm ngôn	adage, proverb, precept
chăm sóc	care
chậm trễ	delay
chạm, sờ	touch
chan	pour (liquid food) over…
chán	bore, lose interest
chân	leg
chăn	blanket
chắn	block, to bar, to obstruct, to stop
chẩn	diagnosis
chặn	blockade
chán 	bored
chắn 	sure
chặn 	block
chăn bò	cow herding
chẩn đoán	diagnose
chẩn đoán được	diagnosable
chấn động	concussion, commotion
chân dung	portrait
chân không	barefoot
chán ngắt	wearisome
chân tay	limb
chăn trâu	buffalo herding
chân trời	horizon
chăng	reasonable?
chẳng	don't, not
chạng	stand astride with legs a bit spread out
chàng 	he/you(male) (literary romantic)
chăng 	(question expression)
chang chang	blazing heat
chằng chịt 	interlaced, interweave
chẳng quản khó nhọc	tireless
chánh	head, chief, main
chao	soya cheese; rock, swing; expression: Oh
cháo	porridge
chào	invite, greet, hello, salute
chào bán	sale offer
chào mừng	welcome
chào tạm biệt	adieu
chấp	to give someone and edge in competition; to accept, grant; to resent, to have grudge against
chắp	folded, join; to clasp (the two hands)
chạp	twelfth month, last month
chập	 fasten together, to twist together
chấp nhận	accept, acknowledge
chấp nhận được	admissible, acceptable
chát	tart
chất	nature; substance, matter; to heap, to pile
chắt	great-grandchildren
chật	tight, lack of space
chặt	to chop
chất 	(chemical) nature
chật 	tight
chất ăn bố	nutriment
chất béo	fat
chặt chẽ	tight
chật chội 	cramped
chất dẫn	conductor
chất dinh dưỡng	nutrient
chất độc	poison
chất đống	to stack
chất gây ô nhiễm	pollutant
chất giảm vận động	depressor
chất keo	adhesive
chất kết dính	adhesive
chất khử mùi	deodorant
chất khử trùng	antiseptic
chất làm giảm độ axit	antacid
chất lỏng	fluid
chất lượng	quality
chất phun	aerosol
chất tẩy rửa	detergent
chất thải	wastes
chất thơm	aromatic
chất xúc tác	catalyst
cháu	niece/nephew
châu	continent
chầu	round, bout, session, period of time
Châu Á	Asia
châu âu	Europe(an)
châu chấu	locust
cháu gái	niece
cháu ngoại	grand children (daughter's children)
cháu nội	grand children (son's children)
cháu trai	nephew
cháy	burned, fire
chày	rice/food-pounding pestle
chảy	flow
chạy	run
chảy 	flow
chạy bộ	jog
chảy máu	bleed
chạy nước rút	sprint
chạy trốn	flee
chạy vụt ra	fling
che	cover, shade
chè	tea, sweet dessert
chê	belittle, put down
chế	prepare, manufacture, invent
chẻ	split
chê bai	to speak scornfully of, to disparage
che đậy	covert, obscure
chế độ ăn uống	diet
chế độ chuyên quyền	autocracy
chế độ quý tộc	aristocracy
che giấu	conceal
che lấp 	cover
chế ngự	overpower
chế nhạo	ridicule, taunt
che phủ	cover
chém	guillotine slash
chen	squeeze to get in
chèn	insert
chen lấn	push and shove
chênh lệch	differential
chểnh mảng	neglect
chéo	diagonal
chèo	to row; a traditional operetta
cheo leo	cliff
chép	copy
chết	die, dead
chết 	die, death
chết đuối	drown
chi	to spend; limb, leg
chí	head louse; will, ambition
chì	lead (metal); tough(slang)
chỉ	merely, only, show; a thread
chị	elder sister(level) female, 1st 2nd person female
chi 	payable
chị dâu	older sister in law
chị em	sisters
chị em họ	female cousins
chị gái	older sister
chỉ một	only one
chi nhánh	branch
chi phí	cost, expense
chỉ ra	indicate
chỉ số	index
chi tiết	detail
chỉ tơ	thread
chỉ trích	criticize
chia	divide, share
chìa	key-like object; to stretch out and show
chia đôi	divide in two
chia được	divisible
chìa khóa	key
chia sẻ	share
chia tay	break-up
chích chòe	magpie
chiếc	single, (unique classifier for an item of a set)
chiếc giày	shoe
chiếc phà	ferry
chiếm 	occupy, capture, take possession
chiếm đoạt	despoil
chiếm hữu 	occupy, capture, take possession
chiêm niệm	contemplate
chiếm ưu thế	dominant
chiến	war, fight
chiến 	fight, war
chiến đấu	combat, fight
chiến dịch	campaign
chiến sĩ	fighter
chiến thắng	victory
chiến tranh	war
chiến trường	battlefield
chiết xuất	extract
chiêu	to recruit
chiếu	a straw mat, project (picture) with light
chiều	afternoon 
chiếu 	projection, shine
chiều cao	height
chiều dài	length
chiêu đãi viên	waiter
chiều kim đồng hồ	clockwise
chiều rộng	width
chiếu sáng	illuminate
chiều sâu	depth
chim	bird
chìm	to sink
chim bồ câu	pigeon, dove
chim hải âu	seagull
chim hoàng yến	canary
chim sẻ	sparrow
chim sơn ca	bluebird
chim trĩ	pheasant
chim ưng	eagle, hawk
chín	nine, 9; ripe
chín mươi	ninety
chính	main, major, principal
chỉnh	to correct, to lecture and correct
chính anh ta	himself
chính giữa	in the middle of
chính họ	themselves
chỉnh lại	changeover
chính người	he himself
chính nó	itself
chính ông ấy	himself
chính phủ	government
chinh phục	conquer
chính sách	policy
chỉnh sửa	cobble
chính thức	official, formal
chính trị	political
chính trị gia	politician
chính xác	accurate, exact, precise
chíp	chip
chịu	to sustain, to bear, to accept
chịu 	subject to
chịu đựng	endured
chịu đựng 	bear, put up with
chịu đựng được	tolerable
chịu được	endure
chịu tốn thất	suffer loss
chịu trách nhiệm	liable
cho	for; to give, to indicate
chó	dog
chỗ	place
chớ	do not
chờ	wait
chở	transport
chợ	market
cho con 	for child(role, person)
chó dẫn đầu	lead-dog
cho đến khi	until
chờ đợi	wait
chó Ét-ki-mô	husky
chờ kết chuyển	deferred
cho là	presume
chó mặt bẹt	pug
cho mẹ 	for mother
chỗ ngồi	seat
chó nhà	house-dog
chỗ ở	accomodation
cho ông	for him
cho ông rằng	for him that
cho phép	to let, allow
chổ phỏng	scald
chỗ rộp da	blister
chó săn	hound, hunting dog
chó sói	wolf
cho thuê	lease
chỗ trốn	hiding place
cho vay	lend
choang	very bright, brightly-lit
choáng váng 	dizziness, stunned
chốc	moment, instant, while
chọc 	poke
chọc thủng	breakage
chòi	cabin
chối	broom
chồi	bud
chơi	play
chơi 	play
chơi giởn	trifle
chơi khăm 	hoax, play trick
chơi nhạc	play music
chơi rong	to loaf
chòm	grove, thicket, tuft; constellation (of stars)
chồm	to prance, to spring up
chỏm	apex
chôn	to bury
chốn	a place
chọn	pick, choose, select
chôn cất	burial
chóng	fast, rapid, quick
chống	resist against(military), stand up against (post hold up roof)
chồng	husband, to stack
chóng 	rapidly
chống 	fight against
chồng bà	her/your husband
chống bằng cột	pole
chồng chéo	overlap
chống cự 	resist, defend against
chóng khỏi 	quickly recover
chống lại	resist against
chống toát mồ hôi	antiperspirant
chóp	peak, tip
chớp	blink
chớp 	blink
chớp nhoáng 	lightning, in a split moment
chợt	suddenly
chú	uncle (father's younger brother)
chủ	master, lord
chứ	rather than
chữ	word
chú 	uncle, he, (sometime: explain phrases)
chứ 	but
chữ 	word
chú bác	uncles
chủ đề	topic
chữ in	print
chu kỳ	cycle
chữ ký	autograph
chủ nghĩa giáo điều	dogmatism
chủ nghĩa tích cực	activism
chủ nhà	host, landlord
chủ nợ	creditor
chú rể	the groom
chủ tịch	chairman
chữ tốt	good language knowledge
chữ viết tay	handwriting
chú ý	attention
chủ ý	intent
chua	sour
Chúa	God
chùa	temple
chưa	not yet
chứa	to contain
chừa	leave, spare, give up
chữa	to cure, to treat, to correct, to repair
chua 	sour
chữa bệnh	cure, medical treatment
chưa chín	raw
chưa giải quyết	pending
chưa khai hóa	barbarous
chúa tể	lord
Chúa Thánh Thần	The Holy Spirit
chưa?	yet?
chuẩn bị	prepare
chuẩn bị trước	prearrange
chúc	wish
chức	title, official
chực	stand by
chúc mừng	congratulate
chức năng	function
chúc sức khỏe	cheers
chúi	dive, bend one's head forward
chùi	wipe
chửi	curse
chửi 	curse
chửi thề 	swearing
chum	large clay jar/container (waist high)
chùm	beam
chụm	to huddle, to bunch, to gather; to light a fire
chung	join, together; in general, in common
chúng	they, (group prefix for us/we/they)
chủng	to vaccinate, to inoculate; type of (noun)
chứng	evidence, proof, nature
chừng	about, rough estimate
chứng 	proof
chứng cứ ngoại phạm	alibi
chứng mất ngôn ngữ	aphasia
chứng minh	prove, demonstrate
chứng minh được	can be proven
chúng nó	they
chung sống	living together
chúng ta	us
chứng thư	deed
chứng thực	endorse
chủng tộc	race, ethnicity
chúng tôi 	we, us
chúng tôi đã	we've
chứng viêm khớp	arthritis
chuộc	to redeem, to ransom
chước	trick, strategy
chuộc lại	redeem
chuộc lỗi	atone
chuối	banana
chuỗi	chain
chưởi rủa	curse
chuồn	dragonfly; to make oneself scarce, to disappear
chuồn chuồn	dragonfly
chuông	bell
chuồng	kennel, cage
chuộng	popular
chương	chapter
chương 	chapter
chường 	show up
chướng ngại vật	barricade
chương trình	program
chương trình giảng dạy	curriculum
chuốt	to polish; to sharpen
chuột	mouse
chuột cống	rat
chuột rút	cramp
chụp ảnh	photograph
chút	little
chút 	little, a bit
chuyên	specialized
chuyền	to pass on to each other
chuyển	move
chuyện	story
chuyến 	trip
chuyến bay	flight
chuyên chế	despotic
chuyện cố tích	fairy tale
chuyến đi	ride, trip
chuyển động	motion
chuyến du lịch	tour
chuyên gia dinh dưỡng	dietician
chuyển giao	transfer
chuyện ngẩu nhiên	incident
chuyên nghiệp	professional
chuyển phát nhanh	express courier
chuyện tào lao	gossip, garbage talk
chuyển tiếp	transition, transfer
chuyện tình cảm	romantic affair
clo	chlorine
co	to contract, to shrink
có	have
cò	stork
cô	aunt (father's younger sister), miss, young lady 
cố	try; great grandfather or mother
cỗ	feast; banquet
cỏ	grass
cơ	occasion; possibility; opportunity; card of heart
cổ	neck
cọ	to scrub, to scour; paint brush
cớ	excuse
cờ	flag
co 	contracting, pull back
có 	there is/are, have
cố 	try, (title for great grandparent)
cỡ 	size
cố áo	collar
cơ bản	fundamental, basic
cơ bắp	muscle
có cảm giác kim châm	prickle
có cảm giác ngứa	tingle
có cảm xúc lẫn lộn	ambivalent
có chừng mức	abstinent
cỏ dại	weed
co dãn	elastic
cô dâu	bride
cô dì	aunts
cố điển	classic
có điều kiện	conditional
cố định	fixed
cô độc	solitary
cô đơn	alone
có dung tích lớn	capacious
có được	acquire
cô gái	girl
cố gắng	try, attempt, trying effort
có giá trị, hữu hiệu	avail
cố giành lấy	wrest
cơ hội	opportunity, chance
cố họng	throat
có khả năng	sufficient, capable
có khả năng học hỏi	acquisitive
có khả năng thích nghi	adaptive
có khả năng thích ứng	adaptive
có khả năng tiếp thu	acquisitive
cỏ khô	hay, dry grass
có lẽ	perhaps
có lợi	beneficial, advantageous
có lợi cho	avail
có lúc	sometimes
có lý, lô gích	argumentative
có mây	cloudy
có mọi quyền lực	almighty
có mùi thơm	(to be) scented
có nghĩa là	mean(t)
có nhiều cây cối	(to be) wooded
có nhịp điệu	cadent
có pha a xít	acidulous
cơ quan	organ, authority, department
có quan hệ chặt chẽ với	adherent
có quyền phúc thẩm	appellate
có rất nhiều	abound
cọ sạch	scrub
cơ sở vật chất	facility
cô ta	her
cổ tay	wrist
cố tay áo	cuff
có thai	(is)pregnant
có thẩm quyền	competent, authorized
co thắt	spasm
có thể	can, possible, able
cơ thể	body
có thể bị giảm giá trị	depreciable
có thể bỏ qua	dispensable, forgivable
có thể nố	explosible
có thể thấy rõ	discernible
cố tích	fairy
có tính chất ngụ ý	allegoric
có tội	guilty
cố tức	dividend
cố vấn	advisor, consult, counsel
có vẻ như	seem
cố vũ	cheer
có xu hướng	tend
cố xưa	primitive, ancient
cố ý	deliberate, intentional
có ý là	meant
có ý thức	conscious, aware
cóc	a toad; never, not at all (attitude)
cốc	mug
cọc	pile
cốc, tách, chén	cup
coi	consider, deem
còi	horn
côi	orphan
cõi	realm, a world
cối	mortar (for pounding food)
cỡi	riding
cởi	remove
coi là	regarded as
coi nhẹ	downplay, take lightly
coi sóc 	take care
coi thường	contempt, despise, disdain
cối xay gió	windmill
còm	skinny, bony
cơm	rice
còm 	skinny
còn	still
côn	wooden baton weapon
cồn	alcohol
cơn	unique classifier (wild event)
còn 	still (have)
cơn ác mộng	nightmare
con bê	calf
con bò chét	tick(bug)
con bọ chét	flea
con cá	fish
con cái	off-spring
con cáo	fox
cồn cát	dune
con cháu	children nephew & nieces; descendant
con chó	dog
con chớ 	don't you(child) 
con chó gần bánh xe	wheel-dog
con chồn	weasel
còn có 	there is/are still
con cóc	toad
con công	peacock
con cọp	tiger
con cú	owl
con cún	puppy
con dao	knife
con dâu	daughter in law
cơn đau	pain
con đẻ	offspring
con đĩ	whore
con đỉa	leech
cơn đói	starvation, hunger
cơn đói điên rồ	hunger-madness
con đường	the path, way
con đường nhỏ	trail
con ếch	frog
con gà	chicken
con gà con	chick
con gái	daughter
con gián	cockroach, roach
cơn giận	fume
cơn giận dử	fury
cơn gió tuyết	snowdrift
con hố	tiger
còn hơi run	still trembling
con la	mule
cơn lốc	twister, tornado
con lợn	pig
con lừa	donkey
con mắt	eye
con mèo	cat
con mồi	prey
còn mới nguyên	new original
con ngao	clam
con ngỗng	goose
con ngựa	horse
con ngựa con	foal
con người	human
còn nguyên	still in one piece, unbroken
con nhím	porcupine
con ong	bee
con quạ	crow, raven
con quỷ	devil
con rắn	snake
con rể	son in law
con rệp	bug, tick-like
con rết	centipede
con rối	puppet
con rồng	dragon
con sâu	grub
con sóc	squirrel
con sói	wolf
còn sống	alive
cơn sốt	fever
con sư tử	lion
cơn thịnh nộ	rage, wrath
con thỏ	rabbit
con thú	beast
con thú con	cub
con tin	hostage
con trai	boy, son
con trăn	boar constrictor, serpent
con trẻ	young child
con trốt	whirlwind
côn trùng	insect
con vật	animal
con vẹt	parrot
con vịt	duck
cong	curve
còng	bent
công	a peacock; labour, work; public
cõng	carried on one's back
cống	portal
cọng	stem, a strand
cong 	curve
công an	police
công bằng	fair
công bố	announce, proclaim
công chính	public
công chúa	princess
công cộng	communal, public
công cụ	tool
công dân	citizen, civic
công đoàn	union
cống hiến	dedicate, devote
công khai	publicly, openly
công lao	merit
công lý	justice
công nhân	industry worker
công suất	capacity
công sức	effort
công tác	despatch
cộng thêm	additional
công thức	recipe, formula
công tố viên	prosecutor
công trình 	project
công tước	duke
công ty	company, firm
công việc	business, task, job, work
công viên	park
côngxecto	concerto
cônic	conic
cọp	tiger
cốt	bone, skeleton, essence
cột	column
cợt	to trifle; to tease
cột giường	bedpost
cọt kẹt	creaking
cót két 	creaking
cù	tickle
cũ	old
củ	bulb, tuber, root (food) (such as potato…)
cư	to dwell; to live
cụ	great elder
cứ	to continue; to keep on
cử	to delegate; to elect
cụ 	title to address an old person
cứ 	just go ahead and (action)
cự 	resist, defend against
cử chỉ	gesture
cừ khôi 	superb with achievement (individual)
cử nhân	diploma
cũ rích	corny
cụ thể	specific
cư trú	residence
cư xử	behave
cua	crab
của	of, belong to
cưa	to saw
cứa	to cut with a blunt knife/object
cửa	door
cựa	to stir; to budge; spurs(of rooster)
của ai	whose
của anh	your
của anh ấy	his (older brother level)
của bà ấy	her (older woman level)
của bác ấy	his/her (elder uncle/aunt level)
của bạn	your
của bạn ấy	his/her (friend level)
của cháu ấy	his/her (niece/nephew level)
của chị ấy	her (older sister level)
của chính mình	one's own
của chú ấy	his (younger uncle level)
của chủ quán rượu	saloon-keeper's
của chúng	their
của chúng ta	belong to all of us
của chúng tôi	our
của cô ấy	her (younger woman level)
của con ấy	her (child level)
của cơn lũ quét	of the storm
của con người	man's
của cuộc sống	life's
của địa ngục	hell's
của đối phương	enemy's
của dượng ấy	his (younger uncle level)
của em ấy	his/her (younger sibblings level)
cửa hàng	shop, store
cửa hàng bách hóa	department store
cửa hiệu	boutique
của họ	their
của mợ ấy	her (younger aunt level)
của một người	one's
của người làm vườn	gardener's
của những người khác	others's
của nó	its
của ông ấy	his (older man level)
cựa quậy	bodily move, stir
của riêng mình	one's own
cửa số	window
của thím ấy	her (younger aunt level)
của thời điểm	moment's
của tôi	mine, my
cục	chunk, cube, block
cực	pole, extreme
cục đá	a rock
cực dương	anode
cực khổ	travail
cực kỳ xuất sắc	ace
cực nhọc	toil, strenuous
cực quang	aurora
cúi	bow
cùi	leprosy; pulp (core of corn, mango)
cũi	crib
củi	firewood
cùm	shackles
cụm từ	phrase
cung	palace; temple; bow; arc; supply
cúng	worship
cùng	same, along, and
cũng	also
củng	to clout on the forehead
cứng	hard
cung cấp	supply, provide
cung cấp lương thực	supply food
cung cấp nơi ở	accommodate
củng cố	consolidate, reinforce
cũng dẻo	also flexible
cung điện	palace
cứng đơ	stiff
cũng gọi là	also known as
cũng không	nor
cũng là	also is
cùng lứa	peer
cùng máu mủ 	the same blood
cứng ngắc	rigid
cùng nhau	together
cũng nhờ có 	also thanks to
cũng như vậy	likewise
cùng quy tụ	converge
cứng rắn	adamant, extremely firm
cùng tồn tại	coexist
cũng vậy	too, as well
cuốc	hoes
cuộc	(unique classifier), the (time related) session 
cuộc biểu tình	rally
cuộc chiến đấu	fight
cuộc đấu (kiếm, súng) tay đôi	duel
cuộc đối thoại	dialogue
cuộc đột kích	raid
cuộc đua	race, competition
cuộc đụng độ	clash
cuộc gọi	call
cuộc họp	meeting
cuộc khám nghiệm tử thi	autopsy
cuộc nối dậy	revolt
cuộc nối dậy/loạn	revolt
cuộc phiêu lưu	adventures
cuộc sống	life
cuộc sống riêng tư	private life
cuộc sống và cái chết	life-and-death
cuộc thi	contest
cuộc trò chuyện	conversation
cuối	end
cưới	wed
cười	laugh, chuckle
cưỡi	riding
cuối cùng	ultimately, in the end, finally
cười lộ răng	grin
cuối mùa hè	late summer
cười nhạo	deride
cuối tuần	weekend
cườm mắt	cataract
cuộn	coil, wrap, roll
cuồn cuộn	billow
cuốn họng	jugular
cuộn mình	cuddle
cuốn sách	book
cuống	stem
cưỡng	to force
cương 	firm up against
cường độ dòng điện	amperage
cưỡng lại	resist, resistible
cương quyết	determined, decisive
cướp	rob
cướp biển	pirate
cúp điện	blackout
cưu	to help; to aid
cứu	rescue
cừu	sheep
cữu	eternal
cửu	nine
cựu	former
cứu dân	save people
cứu hỏa	fire fighting
cưu mang	conceived and carry
cựu sinh viên	alumni
cứu trợ	relief
cựu, trước đây	former
da	leather, skin
dá	palanquin
dã	wild
dạ	stomach; reponse: "Yes ; please" to elder
đa	multiple
đá	to kick; stone, rock
đà	momentum
đã	did, already (past indicator)
đã ấm lên	warmed
đã ăn	ate
đã ẩn	hid
đã ăn cắp	stole
đã bắn	shot
đã bắn phá	bombarded
đã bão	stormed
đã bao bọc	enveloped
đã bảo đảm	secured
đã bao gồm	included
đã bao quanh	surrounded
đã báo tin	communicated
đã báo trước	heralded, informed ahead of time
đã bảo vệ	defended, guarded
đã bắt	caught
đã bắt buộc	compelled
đã bắt cóc	kidnapped
đã bắt đầu	started
đã bất ngờ	unexpected
đã bắt vít	bolted
đã bay	flew
đã bị nhiễm	contracted
đã bị thương	injured, wounded
đã biến mất	disappeared
đã biết	knew
đã bò	crawled
đã bò lê	crept
đã bỏ lỡ	missed
đã bỏ qua	ignored
đã bọc	wrapped
đã bối rối	puzzled
đã bọt khí	bubbled
đã bùng phát	boomed
đã buộc	forced
đã buộc dây 	leashed
đã ca ngợi	hailed, praised
đã cãi nhau	bickered, quarrelled
đã cai trị	ruled
đã cam đoan	reassured
đá cẩm thạch	marble
đã cảm thấy	felt
đã cắm trại	camped
đã cần	needed
đã cắn	nipped, bit (bite)
đã cân nặng	weighed
đã can thiệp	interfered
đã căng thẳng	strained
đã cắt giảm	slashed
đã cấu	scratched
đã cầu nguyện	prayed
đã càu nhàu	grumbled, grunted
đã cày	ploughed
đã chậm phát triển	retarded
đã chán	bored
đã chạy	ran
đã chạy đua	raced
đã cháy sém	fire-scorched
đã chạy trốn	fled
đã chế giễu	taunted
đã chết	died
đã chết đói	famished
đã chết đuối	drowned
đã chỉ	pointed
đã chỉ huy	commanded
đã chiếm	occupied
đã chiến đấu	fought
đã chiết xuất	extracted
đã chìm	sank
đã cho ăn	fed
đã chở bằng xe tải	trucked
đã chờ đợi	waited
đã cho phép	allowed
đã choáng váng	dazed
đã chọc	poked
đã chơi	played
đã chôn	buried
đã chọn	selected, picked
đã chưa xong	unfinished
đã chuẩn bị	prepared, braced
đã chứng minh	evidenced
đã chuyển	shifted
đã chuyên chở	freighted
đã chuyển dời	moved
đã chuyển đối	transformed, changed
đã có	had
đã cố định	fixated
đã cố gắng	attempted, tried
đã có giá trị trước đây	forevalued
đã có mục tiêu	purposed
đã có mùi thơm	scented
đã có nhiều cây cối	wooded
đã có thể	could
đã cọ xát	rubbed
đã cong	curved, bent
đã công bố	announced
đã công nhận	recognized
đã cư trú	resided
đã cúi, co mình	crouched
đã cung cấp chỗ ở	accommodated
đá cuội	boulder, pebble
đã cười	laughed
đã cưỡi	rode
đã cười toe toét	grinned
đã cuộn	rolled
đã cuốn lên	reeled, curled up
đã cứu	saved
đã đá ra	bucked
đã đặc trưng	characterized
đã dám	dared
đã đâm sầm	crashed
đã dẫn	led
đa dạng	diverse
đa dạng hóa	diversify
đã đánh	struck
đã đánh dấu	marked
đã đánh sáp	waxed
đã đánh thức	roused
đã đập	clubbed, pounded
đã đáp lại	countered
đã đập mạnh	throbbed
đã đập nát	smashed
đã đập, vỗ	flapped
đã đặt	placed, laid
đã đạt được	achieved, gained
da đầu	scalp
đã đau đớn	lacerated, was in pain
đã đấu tranh	struggled
đã đầu tư	invested
dạ dày	stomach
đã đẩy	propelled, pushed
đã đầy chiến sẹo	battle-scarred
đã đem	carried
đã đi	gone, went
đã di dời	displaced
đã đi du lịch	travelled
đã đi kèm	bundled, accompanied
đã đi khập khiễng	limped
đã đi lang thang	wandered
đã đi lon ton	trotted
đã đi men	skirted
đã đi nước kiệu	trotted
đã đi qua	passed
đã đi theo	followed
đã diễn hành	marched
đã diễn nhộn nhịp	animated
đã điên rồ	crazed
đà điểu	ostrich
đã điều khiển	driven
đã điều trị	treated
đã định	destined
đã định đường	routed
đã đố	shed, poured
đã đối mặt	faced
đã đối xử	treated
đã đóng	closed, shut
đã đóng dấu	stamped
đã đóng gói	packed
đã đông lạnh	frozen
đã đóng yên	harnessed
đã đớp	snapped
đã dự	attended
đã dự bị	reserved
đã dự kiến	expected
đã dự tính	projected, estimated
đã đưa ra	launched, proposed
đã đưa trước	advanced
đã đụng	crashed
đã đứng	stood
đã đứng đầu	topped
đã được	was able to be (verb); had received (verb)
đã dường như	seemed
đã ép	pressed
đã gầm gừ	growled, snarled
đã gầm lên	roared
đã gắn chặt	fastened
đã gặp	met
đã gặp phải	encountered
đã gấp rút	hurried
đã gật đầu	nodded
đã gáy	crowed
đã gây ra	caused
đã gãy răng rắc	snapped
đã ghét	hated
đã ghi điểm số	scored
đã giải quyết	resolved
đã giảm	dropped, reduced
đã giậm chân	stamped
đã giẫm xéo	trampled
đã giảm xuống	plunged
đã giảng dạy	taught
đã giật	jerked
đã giấu	hid
đã giấu giếm	smothered
đã giết	killed
đã giới hạn	confined
đã giữ	kept
đã giữ chắc	braced
đã giường	bed
đã gõ	knocked
đã gỡ lại	undid
đã gọi	called
đã góp ý	commented
đã gửi	sent
đã hạ	dropped, reduced
đã hạ cánh	landed
đã ham muốn	desired
đã hận thù	hatred
đã hát	sang
đã hết hơi	winded
đã hét lên	shouted
đã hơ khô với ánh nắng	sun-dried
đã hỗ trợ	backed someone up, supported
đã hoà giải	conciliated
đã học	learned
đã hỏi	asked
đã hồi phục	recuperated
đã hướng về	bounded
đã hy sinh	sacrificed
đã kéo	dragged, pulled, towed
đã kéo dài	stretched
đã kéo lết phết	draggled
đã kéo, treo lên	hoisted
đã kết hợp	combined
đã kết thúc	finished
đã kêu ẳng ẳng	yelped
đã kêu lách tách	crackled
đã kêu van	moaned
đã khai quật	unearthed
đã khảo sát	surveyed
đã khó chịu	annoyed
đã khóc	cried, wept
đã khóc nức nở	sobbed emotionally
đã không	was not, did not (verb)
đã không ai để ý đến	unheeded
đã không bị	was not affected by, did not (verb)
đã không bị ảnh hưởng	unaffected
đã không có đếm	unnumbered
đã không được	was not able to (verb), not allowed to (verb)
đã không nao núng	uncowed, unshakened
đã không nghi ngờ	unsuspected
đã không quấy rầy	unmolested
đã không thay đổi	unaltered
đã không theo đuối	unpursued
đã khuấy	stirred
đã khúm núm	fawned
đã kích	goaded
đã kích thích	aroused, excited
đã kiểm tra	checked
đã kiệt sức	exhausted
đã kinh nghiệm	experienced
đã ký	signed
đã là	were, was
đã là khá	was fair
đã lắc	shook
đã lái xe	drove
đã làm	did
đã làm chủ	mastered
đã làm đầy	filled
đã làm nát	crunched
đã làm ngạt thở	smothered
đã làm nhanh hơn	quickened
đã làm sạch	cleaned
đã làm tê liệt	crippled
đã làm tròn	rounded
đã làm việc	worked
đã làm việc vất vả	toiled
đã làm/thực hiện	made
đã lắng tai nghe	harked
đã lao vào	rushed in
đã lao xuống	plunged
đã lặp đi lặp lại	repeated
đã lật đố	overthrown
đã lật úp	capsized
đã lấy	took, taken
đã lấy lại	regained
đã lên cấp	ascended
đã lên tiếng	voiced
đã leo	scaled
đã liếm	licked
đã lo lắng	worried
đã loạng choạng	staggered
đã lóe sáng	flashed
đã lôi	hauled
đã lớn lên	grew up
đã lừa	fooled
đã luồn lách	wriggled
đã lượn vòng	circled
đã lưu	saved
đã lý luận	reasoned
dã man	ferocious
đã mang	carried
đã mạo hiểm	ventured
đã mệnh	destined
đã mỉm cười	smiled
đã mở ra	opened
đã mô tả	described
đã mong muốn	desired
đã muốn	wanted
da nai sừng tấm	moose-hide
đã nài xin	pleaded
đã nắm chặt	gripped
đã nản lòng	daunted
đã nâng lên	raised
đã nạp	loaded
đã né	dodged
đã ném	flung, hurled, threw
đã nện	pounded
đã nêu ý kiến	remarked
đã ngạc nhiên	surprised, astonished
đã ngáp	yawned
đã ngập lụt	deluged
đã nghe	heard
đã nghẹn ngào	choked
đã nghẹn thở	choked
đã nghiền ngẫm ủ ê	brooded
đã nghiêng	slanted
đã nghiêng về	inclined
đã ngồi	sat
đã ngủ	slept
đã ngửi	sniffed
đã ngừng	ceased
đã nguyền rủa	cursed
đã nhai	chewed
đã nhân đôi	duplicated
đã nhận được	received
đã nhận ra	realized
đã nhận xét	remarked
đã nhảy	leaped
đã nhẩy	sprang
đã nhìn	looked
đã nhìn chăm chú	peered
đã nhớ	remembered
đã nhỏ dãi	slavered
đã nhún vai	shrugged
đã nói	spoke, said
đã nói chuyện	talked
đã nói một mình	soliloquized
đã nửa choáng váng	half-stunned
đã nuôi nấng	raised
đã nuông chiều	pampered
đã nuốt chửng	devoured
đã nuốt ực	gulped
đã nứt	cracked
đã ở tình trạng	fared
đã oằn	buckled
đã oằn xuống	sagged
đã phá vỡ	broke
đã phản bội	betrayed
đã phản đối	protested, countered
đã phẩn nộ	raged
đã phân phối	distributed
đã phát đạt	prospered
đã phát hiện	discovered
đã phát triển	grown, developed
đã phóng	dashed
đã phớt lờ	ignored
đã phủ	covered
đã phủ lên	draped
đã phủ tráng	coated
đã phục hồi	recovered
đã phun	sprayed
đã pitched	pitched
đã qua đầu	topped
đã quản lý	managed, administered
đã quằn quại	writhed, squirmed
đã quan sát	observed
đã quan tâm	cared
đã quạt	fanned
đã quay	turned
đã quay lên	reeled
đã quên	forgotten, forgot
đã quét	swept
đã quì	squatted
đã quy định	stated
đã ra dấu hiệu	signaled
đã ra đi	departed
đã ra lệnh	commanded
đã rạch	slashed
đã rên rỉ	whimpered, moaned, whined
đã rít lên	shrieked
đã rối	tangled
đã rơi	fallen, crashed, fell
đã rời bỏ	left
đã run lên	quivered
đã run rẩy	trembled
đã rùng mình	shivered
đã rút lui	retreated
đã rút ra	drawn
đã sai lầm	blundered
đã sẵn sàng, dừng	poised
đã sắp xếp	arranged
đã siết chặt	clasped
đa số	majority
đã sợ	feared
đã sợ hãi	terrified
đã sở hữu	possessed
đã so sánh	compared
đã soi sáng	illumined
đã sống	lived
đã sủa	barked
đã sưng lên	swollen
đã tả tơi	ragged
đã tan băng	thawed
đã tấn công	attacked, assailed
đã tăng	surged, increased, climbed
đã tăng gấp đôi	doubled
đã tạo khả năng	enabled
đã táp	snapped
đã tập luyện	practised
da tay bị chay	callous
đã té	fell
đã té nhào	tumbled
đã thách thức	defied
đã tham gia	joined
đã than van	moaned
đã thắng	won
đã thành công	succeeded, prospered
đã thao diễn	manoeuvred
đã tháo ra	unfastened
đã thất bại	failed
đã thắt chặt	tightened
đã thấy	seen, saw
đã thay đối	changed
đã thay thế	replaced
đã thề	swore
đã thêm	added
đã thèm muốn	coveted
đã theo dõi	stalked
đã thét lên	shrieked
đã thiền định	meditated
đã thở	breathed
đã thoát	escaped
đã thối	blew
đã thốt ra	uttered
dã thú	beastly, wild beast
đã thu	collected
đã thu được	earned
đã thu hút	attracted
đã thụ phong linh mục	ordained
đã thu thập	gathered
đã thừa nhận	acknowledged
đã thuần hóa	tamed
đã thúc đẩy	spurred
đã thực hiện	done, accomplished
đã thực sự	indeed
đã thụt lùi	backed away
đã tích lũy	accumulated
đã tiến hành	proceeded
đã tiếp cận	approached
đã tiếp tục	continued
đã tiết kiệm	saved
đã tìm thấy	found
đã tính	calculated
đã tỏa sáng	glowed
đã trả đũa	retaliated
đã trả lời	replied, answered
đã trần truồng	naked
đã trang bị	armed
đã trang trí nội thất	furnished
đã tránh	avoided
đã tránh xa	shunned
đã trao đối	exchanged
đã treo	hung
đã trì hoãn	delayed
đã trở lại	returned
đã trở thành	became
đã trở thành mềm	softened
đã trôi qua	lapsed
đã trốn	escaped
đã trốn việc	shirked
đã trong tình trạng âm ỉ	smothered
đã tru	howled
đã trữ	reserved
đã trung bình	averaged
đã từ chối	refused
đã tự hào	prided
đã tự hỏi	wondered
đã tua	fringed
đã tuân theo	obeyed
đã tuân thủ	complied
đã tưởng tượng	imagined
đã ước nguyện	aspired
đã uống	drank
đã ướt	wet
đã vào	entered
đã vật lộn	wrestled, grappled
đã vẽ	drew
đã ve vẩy	wagged
đã véo	pinched
đã vinh danh	honored
đã vò nát	crumpled
đã vỗ nhẹ	patted
đã vội vã	rushed, hurry
đã vọt nhanh	sped
đã vui mừng	gladdened
đã vung	swung
đã vươn nanh dựng lông	bristled
đã vượt qua	crossed
đã xâm nhập	pervaded
đã xấu hố	ashamed
đã xảy ra	happened
đã xé rách	torn
đã xem	watched
đã xén	clipped
đã xoắn	twisted
đã xoay	whirled
đã xông vô	stormed in
đã xử lý	dealt
đã xứng đáng	deserved
đã xung đột	clashed
đã xuống	descended
đã yêu	loved
đã yêu cầu	demanded
đắc	aquire
đặc	special; to solidify, thicken, condense
đặc biệt 	special
đặc công	commando
đặc điểm	trait
đặc trưng	characteristic
dai	tough
dài	long
dãi	saliva
dại	wild; stupid
đài	stations, tower
đãi	to treat, to play host
đại	grand, great;  without permission
dãi 	saliva
dại 	wild
đại chúng	mass
đại cương	summary
đại diện	represent
dại dột	rashness, thoughtless, ignorant
đại dương	ocean
đại học	university, college
đại hội	congress
đại lộ	boulevard
đại lý	agent
đài phun nước	fountain
dải san hô	reef
đại sứ	ambassador
đại súng thần công	cannonball
đại tá	commodore, brigadier
Đại Tây Dương	Atlantic
dám	dare
dầm	to soak; to pickle; to crush
dẵm	step on, trample
dặm	mile
đám	mass, patch, group title
đâm	stab
đầm	dame; a pond
đảm	capable, to bear
đậm	bold
đâm 	puncture, stab
đảm bảo	insure, secure
đám đông	crowd
đảm đương	assume
đầm lầy	marsh
đẫm máu	bloody
đám mây	cloud
đảm nhận	undertake
đàm phán	negotiate
đâm sầm 	crash, collide
đẫm sương	dewy
đám tang	funeral
đâm vào	pierce
dán	paste, affix
dân	citizen
dần	gradually
dẫn	lead
dạn	daring; bold
dặn	to advise; to recommend
đan	knit
đàn	(play) instrument (musical), classifier for herd 
đần	dumb, slow, retard
dần 	gradually
đạn (súng trường, súng lục)	bullet
đàn ắc cooc đê ông	accordion
đàn băng giô	banjo
dân chủ	democratic
dẫn đầu	lead
đắn đo	to ponder ; to weigh
đần độn	idiot, blockhead
đạn dược	ammunition
đàn hồi	springy
dấn mình vào	embark
dân ở bán đảo	penisular
đàn ông	man
dân số	population
dang	to extend; to open wide ; to spread out
dáng	general appearance/figure
dâng	dedicate
đang	is/are doing; present continuous indicator
đáng	worth
đàng	street, way
đăng	post
đấng	title for a great person
đắng	bitter
đằng	direction
đẳng	rank; grade; class
dáng 	figure, appearance
đang 	happenning now; in the process of (verb), present continuous
đàng 	direction, way
đang ăn	eating
đang ẩn	hiding
đang băng qua	crossing
đang bảo vệ	defending
đang bay	flying
đang biến mất	disappearing
đang bò	crawling
đang bơi	swimming
đang bơm	pumping
đang bùng phát	booming
đang cãi nhau	bickering, quarrelling, arguing
đang cắm trại	camping
đang căng thẳng	straining
đang cảnh báo	warning
đang cắt giảm	slashing, reducing
đang cau mày	frowning
đang cháy	flaming
đang chảy	flowing
đang chạy	running
đang chảy máu	bleeding
đang chảy theo dòng	streaming
đang chết	dying
đang chỉ	pointing, showing
đang chiến đấu	fighting
đang chìm	sinking
đang chịu tốn thất	suffering
đang cho	giving
đang cho phép	allowing, letting
đáng chú ý	remarkable
đang chụp	catching
đang chuyển	shifting
đang chuyển đối	transforming
đang clipping	clipping
đang có	having
đang cờ bạc	gambling
đang cố gắng	attempting
đang có nghĩa là	meaning
đang cong	curving
đang cúi	crouching
đang cười	laughing, chuckling
đang đâm sầm	crashing
đang dẫn đầu	leading
đang đăng ký	registering
đang đáng ngạc nhiên	surprising
đang đáng sợ	terrifying
đang đánh	beating, striking, hitting
đang đánh đòn	thrashing, punishing
đang đào	digging
đang đập	clubbing
dáng dấp 	figure, appearance
đang đặt	putting
đang đạt được	gaining
đang đạt tới	reaching
đang đau khố	suffering
đang đau lòng	heartbreaking
đang đấu tranh	struggling
đang dạy	teaching, showing
đang day dưa	lingering
đang đẩy mạnh	thrusting
đang đè bẹp	trouncing, squashed
đang đến	coming
đang đi	going
đang đi du lịch	travelling
đang đi qua	passing
đang đi theo	following
đang điều chỉnh	adjusting
đang đố mồ hôi	sweating
đang đốc thúc	rushing, pushing, to hurry
đang đói	starving
đang đối lập	opposing
đang đóng	shutting
đang đóng cửa	closing
đang đóng gói	packing
đang đóng kịch	acting
đang đóng yên	harnessing
đang đớp	snapping, getting big bite
đang đu	swinging
đang đứng	standing
đang đung đưa	swinging
đang dựng lông	bristling
đang dường như	seeming
đang gầm gừ	growling, snarling
đang gầm lên	roaring
đang gặp	meeting
đang ghét	hating
đáng ghét	detestable
đáng giá trị	worth
đang giảm	plunging
đang giảng dạy	teaching
đang giữ	keeping
đang giúp đỡ	helping
đang gục xuống	drooping
đang há hốc miệng	gaping
đang hạ ván	trouncing
đang hành động	taking action
đang hát	singing
đang hiện hữu	being
đang hoàn thành	finishing, completing
đang hoạt động	operating
đang học tập	learning
đang hối thúc	rushing, pushing, to hurry
đang họp	meeting
đang hướng dẫn	guiding
đáng kể	appreciable
đang kéo	dragging, pulling
đang kéo ra	pulling out
đang kêu ẳng ẳng	yelping
đang kêu gào	screaming
đang kêu khóc	wailing
đang khóc	crying
đang không muốn	unwilling
đang khuấy	stirring
đang kiểm tra	examining
đang kiệt quệ	exhausting
đáng kinh ngạc	staggering, surprising
đấng Ki-tô	Christ
đăng ký	register
đang la hét	screaming
đang lái xe	driving
đang làm	doing, making
đang làm đau đớn	agonizing
đang làm gãy	breaking
đang làm tốn thương	hurting
đang lẩn lút	avoiding, skulking
đang lắng tai nghe	harking
đang lao vào	rushing in
đang lao vút	blazing
đang lao xuống	plunging
đang lấp lánh	gleaming
đang lật đố	overthrowing
đang lấy	fetching, retrieving
đang leng keng	jingling
đang liếm	licking
đang lỉnh	avoiding, skulking
đang loạn xạ	scrambling, is chaotic
đang loạng choạng	staggering
đang lôi kéo	hauling
đang lùi	receding
đang lười nhác	loafing
đang mang	bearing, bringing
đang mất tích	missing, lost
đang mỉm cười	smiling
đang mơ	dreaming
đang mở	opening
đang mò mẫm	groping
đang mọc	growing
đang mong đợi	expecting
đang nài xin	pleading
đang nâng	lifting
đang nấu ăn	cooking
đang nghe	hearing
đang nghênh ngang	swaggering
đang ngủ	sleeping
đang ngửi	smelling
đang ngưng chống cự	unresisting
đang nguyền rủa	cursing
đang nhận	receiving
đang nhận được	getting, receiving
đang nhận thấy	noticing
đăng nhập	log in
đang nhấp nháy	blinking, flashing
đang nhặt	fetching
đang nhảy qua	leaping
đang nhìn	looking, seeing
đang nhìn thấy	seeing
đáng nhớ	memorable
đang nhô ra bên trên	overhanging
đang nối bật	striking (affect)
đang nuôi nấng	rearing
đang ở	living
đang phá vỡ	breaking
đang phấn đấu	striving
đang phẩn nộ	raging
đang phân tán	scattering
đang phát triển	growing, developing
đang phù hợp	matching
đang quản lý	administering
đang quằn quại	writhing
đang quảng cáo	advertising
đang quất roi	whipping
đang rạch	slashing
đang rên rỉ	whining
đang réo inh ỏi	jangling
đang rỉ nước	dripping
đang rít lên	shrieking
đang rơi	falling
đang roi vọt	lashing
đang run rẩy	quivering, shivering, trembling
đang săn bắn	hunting
đang sẵn sàng	willing, ready
đằng sau	behind
đang say mê	infatuating
đang sống	living
đang sục sạo	nosing, searching
đang sùi bọt	frothing
đang sưng	swelling
đang suy nghĩ	thinking
đang tan băng	thawing
đang tấn công	attacking
đang tăng	rising, surging
đang tạo bọt	foaming
đang tạo kết quả	resulting
đang táp	snapping, getting big bite
đang tát	slapping
đang tắt	shutting
đang tay nắm chặt	clutching
đang thách thức	challenging
đang than van	wailing
đang thấy	looking, seeing
đang thay đối	changing
đang thể hiện	expressing
đang thè lưỡi	lolling
đang thét lên	shrieking
đang thở hốn hển	panting
đang thở hốn hển lấy hơi	gasping
đang thối	blowing
đang thốn thức	sobbing
đang thực thi	enforcing
đáng thương	pitiful
đáng tiếc	pity
đang tin	believing
đang tính	calculating
đang tỉnh dậy	waking
đang tố chức	organizing
đang treo	hanging
đang trêu chọc	teasing
đãng trí	absent-minded
đang trích dẫn	quoting
đang trở thành	becoming
đang trở về	returning
đang trôi	drifting
đang trốn	hiding
đang trốn tránh	avoiding, skulking
đang trong khi	during
đang trong phạm vi	ranging, within range
đang trong tầm	ranging, within range
đang tru	howling
đang trú ẩn	sheltering
đang trưng bày	showing, displaying
đang từ chối	refusing
đang tua tủa	bristling
đang vận chuyển	shipping
đang vặn mạnh	wrenching
đang vang dội	resounding
đang vật lộn	wrestling
đang vẫy tay chào	waving
đang vẽ	drawing, painting
đang vi phạm	offending
đang vỡ vụn	splintering
đang với	reaching
đang vội vàng	rushing, pushing, to hurry
đang vòng quanh	circling
đang vươn nanh dựng lông	bristling
đang xáo trộn	scrambling, shuffling
đang xây dựng	building
đang xem	onlooking, watching
đang xem xét	considering, investigating
đang xoắn	wrenching
đang xử lý kỷ luật	disciplining
đáng yêu	lovely
đang yêu cầu	demanding
danh	name
dành	to save; to reserve for
đánh	hit
đành	reconcile oneself to, resign oneself to
dành 	save for, struggle to get
đánh 	beat
danh bạ	directory
đánh bạc	gamble
đánh bại	beat
đánh bắt cá	fishing
đánh bóng	polish
đánh cá ông	whaling
đánh chặn	intercept
đánh dấu	marks
đánh đòn	thrash
danh dự	honor(able)
đánh giá cao	appreciate
đánh giá quá cao	overestimate
đánh lạc hướng	fake one's trail
đánh lừa	to fool
danh nghĩa	nominal
đánh thức	wake
danh tiếng	fame, reputation
danh từ	noun
đánh vần	spell
Đan-mạch	Danish
dao	knife
đáo	to attain; to reach
đào	burrow, dig
đảo	island
đạo	road; way
đảo 	Island
đảo chính	coup
đạo đức	virtue, moral, ethical
đạo đức giả	hypocritical
dao găm	dagger
đào tạo	train
đạo thiên chúa	Catholicism
đạo tin lành	Christian
đáp	to land; to answer
đắp	to cover
đạp	to pedal, to push with feet
đập	dam, to beat
dập 	bruise, stomped
đáp 	respond
đập 	pound, beat, (water dam)
dập dềnh 	water motion in waves
đập mạnh	bash
đập nước	weir
đáp ứng	meet/satisfy requirement
dắt	lead, to tow; to guide
đất	earth, land, soil
đắt	expensive, hot
đạt	achieve
đặt	set, place, put
đặt cược	bet
đạt được	obtain, gain, achieve, attain
đặt giá	bid
đất hoang	wasteland
đặt nhầm	misplace
đặt ra	lay out
đất sét	clay
đặt tên	give name
đắt tiền	expensive
đạt tới	reach, achieve to
đạt xuất sắc	excelled
dầu	oil
dẫu	though
đau	hurt, pain
đâu	where
đấu	to battle; to fight; a bushel
đầu	head
đậu	to perch; bean
dấu 	marking, symbol
dầu 	oil
đầu bếp	cook, chef
đau buồn	sorry, grieve, grief
dấu chấm	dot
dấu chấm than	exclamation mark
đầu cơ	speculate
đau đầu	headache
đau đớn	pain, painful, agony
đấu giá	auction
đầu gối	knee
đầu hàng	capitulate
dấu hiệu	a sign
đau khố	suffering, misery
dầu là ai	whoever
đầu máy xe lửa	locomotives
dầu mỡ	grease
dấu ngoặc đơn	bracket
dấu ngoặc kép	quotation mark
đau nhức	ache
dấu phẩy	comma
dấu phẩy thập phân	decimal point
đậu phộng	peanut
dẫu sao chăng nữa	anyhow, anyway
đấu thầu	tender
dầu thoa	balm
đầu tiên	first
đấu tranh	struggle
đấu trường, vũ trường	arena
dấu vân tay	fingerprint
dấu vết	trace
đau xót 	painful, anguish
đau 	pain
dày	thick
dây	wire, rope, string
dãy	array
dạy	teach
dậy	to rise up
đáy	bottom
đày	to exile; to banish
đây	here, this
đấy	there
đầy	full
đẫy	fat
đẩy	propel, push
đậy	cover
dạy 	teach(ing)
dậy 	get up
đấy 	there
dạy bảo 	teach
dây buộc	leash
dây cáp	cable
dây chuyền	chain
dạy con 	teach you(child)
dây cương	rein
dây da roi	lash
dây đai	strap
đầy đủ	complete, plentiful, full, amply, adequate
day dưa	linger
đây là	this is
đầy lố	full of holes
dây lưng	belt
đẩy mạnh	boost
đầy mưu kế	cunning
đầy sự tôn kính	worshipful
đầy tham vọng	ambitious
dây thừng	rope
đầy tia máu	blood-shot
đầy tính toán	shrewd
đầy, đầy đủ	full
dđáng khen	complimentary
dè	to spare; to expect
dê	goat
dế	cricket
dễ	easy
dể	despise, hold in contempt, disdain
đè	to press weight on
đê	dam
đế	base support (object)
đề	subject, to write
đẻ	bear
để	put, let, so that
đệ	I, me (close equal level); order rank
đè 	press
đề 	topic
đề án	scheme
dễ bảo	obedient
đè bẹp	crush
dể bị	prone, easy to be affected
dễ bị làm hại	vulnerable
để cảm nhận	(in order) to feel
đề cập đến	mention
dễ chịu	agreeable, pleasant, easy-going
để cho 	for
đề cử	nominate
dễ dàng	easy
dễ dàng hơn	easier
đe doạ	threaten
đe dọa	threaten
để được	in order
đế giầy	baseplate
dễ hiểu	easy to understand
để lại	leave
đè nén	suppress 
đệ nhất phu nhân	first lady
dễ nhớ	catchy
để nuôi 	to feed
dễ thương	cute
đê tiện	vile, low life
dễ tiêu thụ	digestible
dễ tính	easy-going
dễ uốn	ductile, easy to bend
dễ vỡ	fragile
đề xuất	propose
đem	bring
đêm	night
đếm	count
đem 	bring
đệm nhạc	accompany (musically)
đêm trước	eve
đen	black
đèn	light
đến	arrive, come, going to, reach destination
đền	temple
đến lúc	till
đèn nháy	flash
đèn pin	flash light
đến trước	precede
đến với	toward
dẻo	elastic, flexible
đeo	wear, put on
đẽo	to carve, to cut (on wood)
đeo đuổi	dangle
dép	slipper, sandals
dẹp	to clean up; to repress; to quell
đẹp	beautiful
dẹp 	clean up
đẹp 	beautiful
đẹp trai	handsome
dệt	weave
đẹt	stunted, limited growth
đều	even; regular; steady
đều 	also, same in comparison
đều đều	dully, steady and continuous
di	to move; to leave behind
dì	aunt (mother's younger sister)
dị	odd; strange
đi	go, leaving
đi bộ	walk
đi chậm lại	decelerate
đi chơi rong	to loaf
di chuyển	move
di cư	emigrate
đi dã ngoại	picnic
đi dạo	stroll
đi đâu	go whereto?, go anywhere
di động	moveable, mobile, portable
đi du lịch	travel
dị giáo	heretic
đi học	(go to) attending school
đi kèm	accompany
đi khập khiễng	limp
đi lại	ambulatory
đi lại được	ambulant
đi làm 	go to work
đi lang thang	wander
đi qua	to go accross
đi trên dây	walk on rope
dị ứng	allergy
đi vênh váo	prance, walk with arrogant attitude
đi xa	recede
đi xe	ride in vehicle
đi xuống	descend
đĩa	plate
địa	location, land
địa chất	geological
địa chỉ	address
địa cực	earth pole
địa điểm	site
địa lý 	geography
địa ngục	hell
địa ốc	real estate
địa phương	local
dịch	translate
đích	landing
đích 	target, destination
địch 	enemy
dịch bệnh	epidemic
đích thực 	true, actual
điếc	deaf
điếm	whore
điềm	omen
điểm	point, score
điểm mốc	benchmark
điểm số	score
điềm tĩnh	calm
điểm yếu	weakness
diễn	to display, perform
điên	mad, crazy
điền	fill
điển	classic reference
điện	power
điên 	mad
điện ảnh	cinematic
điện cực	electrode
điên dại 	crazy and wild
điển hình	typical
điên loạn	mania
diện mạo	appearance
điên máu chiến tranh 	war-mad
diễn ra	take place
điên rồ	mad
điện tâm đồ	electrocardiogram
diễn tập	rehearsal
điện thoại	telephone
điện thoại di động	mobile phone
diện tích	area
điên tiết 	(blood boiling) mad 
điện toán đám mây	cloud
diễn xuất	performance
diệt vong	apocalypse, doom
diều	kite
điếu	a cigarette, smoke pipe; to visit and condole on somebody's death
điều	item of conversation/discussion
điệu	melody; princess-like; to march someone off
điều chắc chắn	certainty
điều chỉnh	tune, adjust
điều đó	that
điều độ	moderate
điều động	mobilize
điều dưỡng	nursing, recuperating
điêu khắc	sculpture
điều khiển	control
điều kiện	conditional, requirement
điêu ngoa 	exaggerating
điều tra	investigate
điều trái lại	contrary
điều trị	treat
dính	to stick
đình	communal house in village; to stop ; to stay; to delay, to put off
đỉnh	peak, summit, apex
định	intend
đỉnh cao nhất	acme
dính chặt vào	adhese, sticks firmly to
đình chỉ	abeyance
định đề	postulate
đỉnh điểm	climax
dinh dưỡng	nutrition
định giá	appraise
đính kèm	attach
dính kết	cohesion
dính liền	cohesive
định luật	general rule/law
định mệnh 	fate
định nghĩa	definition
định ngữ	adjunct
định tâm	intend
dinh thự chính thức	official residence
đinh vít	scew
dịp	occasion
dịu	tender, solf; sweet
dò	probe
dỗ	coax
dơ	dirty
dở	Incapable, bad, unfinished
đo	measure
đó	there
đô	of metropolitan
đố	pour (out, away)
đồ	map, blueprint; thing; object (classifier)
đỗ	to stop and park(car); to pass an examination
đỏ	red
đờ	motionless, lost in thought
đỡ	support, hold up (something), to relieve; of temporary
độ	degree
do 	by, caused by
dọ 	check, measure
đó 	that
đỏ 	red
đỡ 	support
độ 	degree
đố (rác)	dump
độ ẩm	moisture
đồ ăn	tack
dơ bẩn	dirty
đồ bằng đất nung	earthenware
độ C	Celsius
độ cao	altitude
đồ chơi	toy
đồ cố	antique
độ cong	sag
độ cứng	stiffness
dò dẫm	grope
dọ dẫm	grope, feel/figure the way by hand or foot
độ dày	thickness
đỡ đẻ	deliver
do đó	thus, therefore
độ dốc	slope
đố dồn	accrue
đồ dùng	utensils
đồ dùng rồi	second hand
dô ga	yoga
đồ gốm	ceramic
đó là	it is, that is
độ lệch	declination
đố lỗi	blame
đồ lót	underwear
đo mắt	eye measurement
đồ may mặc	garments
đố nát	desolate, crumble
độ nghiêng	lean
đồ ngốc	squarehead
đồ nhân tạo	man made
đồ nội thất	furniture
đô thị	metropolis
đỏ tươi	scarlet
đồ vật	object, stuff
độ 	degree; measure
đọa	to banish; to exile; to damn
đọa đày	damned
đoái	remember with longing
đoàn	legion
đoạn	section, part, portion, passage, paragraph; to cut
đoán 	guess
đoạn 	section, part
đoàn kết	unite
đoạn xướng âm	vocal
doanh trại	barrack
dốc	slope, steep incline
dọc	along the length of
đọc	read(ing), recite
độc	toxic
độc ác	cruel, devilish
độc đáo	unique
độc đoán	dogmatic
dốc đứng	bluff
độc giác ngư	narwhal
độc lập	independent
độc quyền	monopoly
đọc rõ ràng	articulate
độc tài	dictatorial
độc thân	bachelor, bachelorette, single
dọc theo	along side
độc tố	toxin
dốc xuống	downslope
dõi	to follow closely; to pursue
dối	lie
dời	displaced, move
dội	bounce
đói	hungry
đòi	demand
đôi	double, pair
đối	change,exchange
đồi	hill
đời	life 
đội	team
đợi	bide
dội 	bounce
đói 	hungry
đòi 	claim, demand, ask for
đối 	change
đội 	team
đợi 	wait
đội bảo vệ	body guard
đôi bên	reciprocal
đòi bồi thường	claim
đói cào	ravenous
đội chó	team-dogs
đối diện	opposite
đối diện 	face opposite, confront
đội hợp ca	choir
đôi khi	sometimes
đòi lại	reclaim
đối lập	oppose
đối phương	opponent
đối tác	partner
đối thoại 	dialogue, converse
đối thủ	competitor
đội trưởng	captain
đối với	toward
đối xử	treat
dởm	pretentious, fake
đốm	a spot
đờm	phlegm, sputum
đốm 	spot
dồn	cumulative, cram , build up
dọn	move, organize
dợn	ripple, wave motion
đón	welcome, greet
đòn	punishing blow
đồn	rumor
đơn	single unit, individual
đón bà	welcome and take her
đon đả 	warmly and eagerly
dồn dập	deluge
đơn đặt hàng	purchase order
đơn điệu	monotonous
đơn độc	single and alone
đơn giản	plain, simple
dồn lại	accrue
đơn thưa kiện	plaint
đơn thuốc	prescription
đón vợ	welcome and take wife
dong	drive; escort (animal)
dòng	line
đong	measure (grain, corn..)
đóng	close
đông	east; crowded; to freeze
đống	crowd
đồng	copper
đọng	to stagnate, collected under (about water)
động	action
dòng 	line, flowing body (of water)
đống 	pile
động 	movement
đồng bạn	mates, fellow, companion
đóng băng	freeze
đồng bằng	a plain (flat area)
đồng bảng	pound
đồng chí	comrade
đồng cỏ	pasture, prairie
động cơ	motive
đóng cục	curdle
đông dân	populous
động đất	earthquake
đồng đều	uniform
đồng đội	team-mates
đóng gói	pack, wrap
đóng góp	contribute
đồng hồ	clock
đồng hồ đeo tay	wristwatch
đóng kịch	acting (drama)
đồng lõa	complicity
động mạch	artery
đồng minh	ally
đồng nghiệp	colleague
dòng nước chảy xiết	torrent
đồng quy	concurrent
đóng sầm	slam
đồng thau	brass
đồng thau 	brass
động vật	animal
động vật ăn cỏ	herbivore
động vật ăn tạp	omnivore
động vật có vú	mammal
động vật da gai	echinoderm
động vật học	zoology
động vật lưỡng cư	amphibian
đồng xu	coin
đồng ý	consent, agree
đớp	bite
đớp 	bite, chomp, snap
dốt	stupid, lack of learning
đốt	burn
đợt	phase, wave
dột 	leak (water)
đột biến	mutation
đốt cháy	burn, ignite
đột ngột	sudden, abrupt
đột ngột 	sudden
du	to travel
dù	though, eventhough
dụ	lure, entice
dữ	mean, fierce
dự	attend; of planned ( )
đủ	enough, sufficient
dụ 	entice
đu 	swing
dự án	project
dư ảnh	afterimage
dự báo	forecast
dữ dằn	fierce
du đảng	gangster
dự định	destine
dụ dỗ	seduce
dụ dổ	tempt
dự đoán	predict
dữ dội	intense
đủ khả năng	afford
du lịch	travel
du lịch trên tàu	cruise
dữ liệu	data
dự phòng	spare
dù sao đi nữa	nevertheless
dự thảo	draft
du thuyền	yacht
dự tính	contemplate
dự toán	estimate
dữ tợn	ferocious, aggressive
dự trữ	reserve
dưa	melon
dựa	lean 
đua	race
đùa	joke
đũa	chopstick
đưa	send, give
đứa	subordinate pronoun for individual
đùa 	joke
đũa 	chopsticks
dưa chuột	cucumber
dưa hấu	watermelon
đưa lên 	raise up
đua ngựa	horse racing
đưa ra	pose
đưa thư	deliver mail
đứa trẻ	kid
đưa trước	advances
dựa vào	rely
đưa xuống 	bring down
đúc	casting
đục	cloudy(liquid); to chisel
đức	virtue; pronoun of high standing or holy individual
Ðức Giêsu	Jesus
Ðức Giêsu Kitô	Jesus Christ
đức hạnh	virtue
đức tin	faith
đức tính	virtue
dục vọng	lust, hunger for
đui	blind
đùi	lap, thigh
dùi 	hand club, baton
đùm	to wrap; to envelope; a bunch
đun	to heat; to boil; to warm to push; to shove
đun sôi	boil
dung	tolerant
dùng	use
dưng	to offer; to proffer
dụng	use
dừng	stop
dựng	to erect, build up
đúng	right, correct, true
đứng	stand
đừng	do not
dừng 	stop
dựng 	raise to stand up
đứng 	stand
dũng cảm	brave, courageous
đụng chạm	impact
dụng cụ	tool, instrument
dụng cụ 	instrument, tool
đứng đắn	decent
đứng dậy	stand up
dung dịch làm nguội	coolant
đung đưa	swing
đúng giờ	punctual
đúng hẹn	punctual
dựng lên	erect
dùng một lần	disposable
đừng ngại	do not be afraid
đũng quần	crotch
đứng thẳng	erect
đứng thứ ba	third
đúng vậy	indeed
dược	of medicine, pharmacy
đuốc	torch
được	able to/to-be (verb); allow to/to-be (verb)
dưới	under, below
đuôi	tail
đuối	exhausted, very weak
đuôi 	end, tail
đuối 	chase
đuổi bắt	chase
dưới cùng	bottom
dưới đây	below
dưới gió	leeward
đuối theo	chase
đuổi việc	lay off
dưỡng	to nurse, to nourish
dượng	the husband of the direct aunts (also used to address one's stepfather)
đương	in the process of
đường	way, road, (sugar)
đường bao quanh	contour
đường biển	coastline
đường cao tốc	highway
đường cong	curve
đương đại	contemporary
đương đầu	cope, confront
đường hô hấp	respiratory air path
đường kính	diameter
đường lái xe vào nhà	driveways
đường may nối	seam
đường mòn	trail
dường như	seem like, seem
đường phân nước	watershed
đường phố	street
đường ranh giới	baseline
đường sắt	railroad, railway
đường tắt	shortcut
dứt	end
đứt	tear, break 
đứt 	cut off
dứt khoát	distinct
đút lót	bribe
duy nhất	one and only
duy trì	maintain
duyên dáng	delicacy
duyệt	browse
duyệt binh	parade
duyệt trước	preview
ê	hey
ê 	hey
e sợ	afraid, apprehensive
ếch	frog
Ê-cốt	Scotch
em	I/you (younger brother/sister level)
êm	soft, fluffy
em 	title to address a younger person
êm ái	soothing
em bé	baby
em dâu	younger brother/sister in law (wife side)
êm dịu	mellow
em rể	brother in law (husband side)
eo	waist
ép	squeeze
ép 	press, pressured
ép buộc	constrain, compulsory
ga	train station, gas 
gà	chicken
gả	to give in marriage
gã 	that guy (a bit negative connotation)
gà trống	rooster
gác	guard
gác mái	attic
gạch	brick
gạch sống	adobe
gai	thorn
gái	girl
gãi	scratch
gải	terminal
gái điếm	whore
gái già	old maid
gầm	roar
gặm	gnaw
gầm gừ	growl, snarl
gan	liver
gân	tendon
gần	near, close
gắn	connect
gần đây	recent
gần đúng	approximate
gần gũi hơn	closer
gần kề	adjacent
gần như	almost
gắng	to endeavour; to strive
găng tay	gloves
găng tay hở ngón	mitten
ganh	contend, compete
gánh	to shoulder; to bear a responsibility
gánh nặng	burden
gạo	rice
gào 	scream, cry out
gấp	fold
gặp	meet
gấp 	to fold, in a hurry
gấp gáp	hurry
gạt	to push aside; to dupe; to cheat
gặt	to reap, to harvest; to cut
gắt 	intense
gật 	nod
gật đầu	nod
gặt hái	reap
gầu	dandruff
gay	intense
gáy	nape
gây	cause
gãy	fracture
gầy	thin, gaunt
gậy	a stick
gay 	intense
gáy 	to crow
gây 	cause
gây chết người	lethal
gậy chỉ huy	baton
gay gắt 	intense
gây giống	breed
gây khó chịu	bothersome
gậy leo núi	alpenstock
gây nguy hiểm	endanger
gây nhầm lẫn	confuse
gây ô nhiễm	pollute, contaminate
gây tranh cãi	controversial
gây tử vong	fatal
ghé	to drop in
ghê	horrified, scary
ghế	chair
ghẻ	scabies
ghế bành	armchair
ghế dài	bench
ghê sợ	frightful
ghê tởm	abominable, abhor
ghế trống	vacant seat
ghen	jealous
ghen tị	envy
ghen tuông	jealous
ghềnh	water rapid
ghẹo	tease
ghép	hybrid
ghép lại	composite
ghét	hate, loath, detest, hate
ghét cay ghét đắng	abominate
ghi	record
ghi âm	audio record
ghi chép	record
ghi chú	note
ghi nhớ	memorize
ghi nợ	debit
gì	what
gỉ	rust
gia	of family; to increase
giá	price
già	old
giã	to grind; to bray; to crush
giả	dummy, fake
già 	old
giá cả	price
gia cầm	poultry
gia đình	family
giả định	assumption
giá đỡ nến	candlestick
gia hạn	extent
giả mạo	bogus, fraud
gia phả	family tree
gia sư	tutor
gia súc	cattle
gia tộc	family
gia tốc kế	accelerometer
giá trị	value
giá vé máy bay	airfare
gia vị	condiment
giả vờ	pretend
giấc	a deep session of (sleep/dream); classifier
giặc	enemy
giấc 	a session of sleep or dream
giấc mơ	dream
giác quan	sense
giai	boy
giãi	open (one's feeling)
giải	award; prize; to deliver, to conduct under escort; to deliver, to conduct under escort
giai điệu	melody
giai đoạn	phase, period
giải độc	detoxify
giải lao	recesse
giải mã	decode
giải mẵ	decipher
giải ngân	disburse
giải pháp	solution
giải phẫu	anatomy
giải quyết	solve, deal, resolve, settle
giải ráp vũ khí	disarm
giải thích	interpret, explain
giai thoại	anecdotal
giải thưởng	prize, award
giải tỏa mặc cảm	abreact
giải trí	entertain
giẫm	trample
giảm	lower, decrease, reduce
giậm	stamped
giam 	imprison, lock up
giẫm 	trample
giảm bớt	lessen, diminish
giảm dần	downward
giảm đau	reduce pain
Giám đốc	director
giảm giá	discount
giảm giám trị	depreciate
giam giữ	detention, confine, detain
giám hộ	custody
giám mục	bishop
gian	tricky; dishonest; disloyal; a compartment/room
giàn	frame
giận	angry, upset
gian 	criminal
giản dị 	simple
gián điệp	spy
gián đoạn	interrupt
giận dữ	fury, furious
giàn giáo	crane
gian hàng vé	ticket booth
gian lận	fraud
gián tiếp	indirect
gian truân	arduous
giang	river
giảng	preach
giáng cấp	demote
Giáng sinh	Christmas
giành	to claim, struggle to attain
giành 	struggle to get/possess
giành chiến thắng	struggle and achieved victory
giành được	acquire, struggle and achieve
giao	to entrust; to assign; to deliver; to hand over
giáo	lance; spear;  to teach; to educate
giao chiến	belligerent
giao dịch	transact
giáo điều	doctrinaire
giáo dục	educate
giao hàng	delivery
giáo khu	diocese
giáo lý	dogma
giao phó	consign
giáo sư	professor
giáo sỹ	cleric
giao thông	traffic
giao thông vận tải	transportation
giáo viên	teacher
giáp	adjoin
giật	jerk
giặt	washing (laundry)
giật 	snatch, shock(electric)
giật lấy	snatch
giật mạnh	yank, jerk
giật nẩy lên	gasp
giặt ủi	laundry
giàu	rich
giấu	hide, put away
giàu có	wealthy
giày	shoes
giây	second
giấy	paper
giấy chứng nhận	certificate
giày da	leather shoe
giày đi tuyết	snowshoe
giấy phép	permit, license
giây ràng ức	breast-band
giày thể thao	sneakers
giấy ủy nhiệm	credential
giẻ	rag
giẻ lau sàn	rag to clean the floor, mops
giêng	January
giếng	well
giềng	main rope (of a fishing-net)
giếng nước	well
gieo	to sow; to spread; to drop down
giết	kill, slay
giết người	homicide, murder
gìn	to keep; to preserve
gió	wind
giỗ	death anniversary
giỏ	basket
giơ	to show; to raise
giờ	hour
giở	open (a book), unfold (a newspaper, a folder shirt...)
gió 	wind
giờ đi ngủ	bedtime
gió lốc	whirlwind
gió lùa	draught
gió nhẹ	breeze
giỏ xe	cart
giỏi	adept
giọi	to shine; to flash
giới	category, class, group
giỏi 	good
giỏi giang 	helpful and handy
giới hạn	limit
giới học viện	academia
giới thiệu	recommend
giới từ	preposition
giòn	crispy
giòn nát	crunch
giống	resemble, breed
giọng	tone, accent
giọng 	voice
giọng nam trầm	bass
giọng nam trung	baritone
giống nhau	alike, identical
giống nhau như đúc	identical, look alike as from the same mold
giống như	look like, alike, just like
giọng nói	voice
giọt	drop
giọt nước mắt	tear
giọt sương	dew
giữ	hold, keep
giữ lại	withheld, retain
giũa	to file, to sand down with tool
giữa	amidst, between, mid, amidst
giữa đường	midway
giữa lúc	amid
giục	to press, to nudge
giụi	to rub, to stamp out
giùm	help, from; for; on behalf of …
giun	earthworm
giun đất	earthworm
giường	bed
giường cũi	cot
giường tàu	berth
giúp	help
giúp đỡ	help
giựt	snatch, jerk
gò	beaten
gõ	knock
gỗ	wood, timber
gỗ làm nhà	timber
gỗ mun	ebony
gỡ ra	detach
gố trôi dạt	driftwood
góa	widow
góa phụ	widow
góc	corner, angle
gốc	origin, root
gốc 	origin, root
gốc tích	origins
gói	pack, wrap
gối	pillow
gọi	order
gội	shampoo hair
gợi	to rouse; to suggest
gọi hồn	conjure
gọi tên	name, call the name
gợi ý	hint
gợi ý một cách thân mật	intimated
gôm	erase
gốm	pottery
gồm	including
gớm	disgusting(expression), nasty
gồm có	consist
gòn	cotton-wool
gọn	neat
gọn gàng	neat
góp	contribute
gót 	heel
gót chân	heel
gọt vỏ	pare
gục 	to bend down
gửi	send
gửi 	to send
gửi qua bưu điện	mail
gừng	ginger
guốc	wooden sandal, clogs
gươm	sword
gương	mirror, example
gượng	strained; forced; unnatural; reluctantly
há	open mouth wide
hạ	bang
há hốc	gape
hạ mình	demean
hã nhặn	decorous
hạ thấp giá trị	debase
hạ xuống	descent
hắc	black color, pungent
hạch	gland; to demand satisfaction
hai	two
hái	pick
hãi	to fear; to dread; to be afraid of
hại	harmful; hurtful; damaging
hái 	to pick
hại 	damage
hài hòa	harmony
hài hước	comedy, humor
hai lần	twice
hài lòng	satisfaction
hải ly	beaver
hai mươi	twenty
hai năm	two years
hai ông bà	two grandparents
hải quân	navy
hai tay 	two hands
hai tròng	bifocal
hai tuần một lần	bi-weekly
ham	greedy; eager
hám	greedy for
hàm	jaw
hẩm	nasty; smelling or tasting sour or stale
ham chơi	just like to play
hầm chứa	celler
hăm dọa	menace, blackmail
hăm he	threatening
hâm mộ	admire
ham muốn	desire, lust
hàm răng	denture
hàn	caulk
hắn	he/him
hẳn	surely; certainly; completely; for good
hạn	limit; term; a drought
hận	hate; resentful
hắn 	he
hạn chế	abridgment, restrain, restrict
hàn gắn	heal
hạn hán	drought
hạn hẹp	obtuse
hân hoan	delight, joyful
Hàn Quốc	Korea
hàng	product; row; every
hăng	fresh; frisky (horse); acrid (smell)
hạng	class; rank; kind; category
hăng 	motivated, smell of (scent)
hàng chục	dozen
hàng đầu	premier
hang động	cave
hàng gửi	consignment
hăng hái 	enthusiasm
hãng hàng không	airline
hàng hóa	merchandise, goods, cargo, commodity
hang lớn	cavern
hạng mục	category
hàng năm	yearly, annual
hàng ngàn	thousands
hàng ngày	everyday, daily
hàng rào	fence
hàng rào ngăn cách	hedge
hàng tháng	monthly
hang thú dữ	den
hàng tồn kho	inventory
hàng trăm	hundreds
hàng xóm	neighbor
hăng, cay sè	acrid
hành	onion
hạnh	apricot-tree; good nature behaviour
hành động	take action, to act
hành động giết người	homicide
hành hạ	torture, torment
hành khách	passanger
hành lang	corridor
hành lý	baggage, luggage
hạnh nhân	almond
hạnh phúc	happy, happiness
hành ta	scallion
hành tinh	planet
hành trình	journey
hành vi	conduct, behavior
hành vi phạm tội	offence
hành vi trốn tránh	avoiding behavior
hao	to waste
hào	a dime; ditch; moat; trench
hão	vain; not real
hảo	good; kind; beautiful
háo hức	eager
hào hứng 	excited, elated
hão huyền	vain
hào phóng	generous
hấp dẫn	attract
hấp thu	absorption
hấp thụ	absorb
hát	sing, chant
hất	to shake off
hạt	particle, bead, grain, seed, nut, (unique classifier for these)
hất 	toss, buck off
hạt đậu	pea
hạt dẻ	chestnut
hạt giống	seed
hắt hơi	sneeze
hàu	barnacle
hầu	to serve
hậu	back; behind; future
hau háu 	hungy attention to
hậu môn	anus
hầu như	almost
hầu như không	barely, scarcely
hậu quả	outcome, consequence
hãy	let; let's; still; yet
hãy 	let us
hãy cẩn thận	beware
hãy cho, để	let
hay đau	sickly
hay làm việc thiện	beneficent
hay thay đối	changeable
hè	summer
hề	clown; ever
hễ	if; whenever
hệ	branch, system
hệ thống	system
hệ thống thoát nước	drainage
hẻm	alley
hẻm núi	gorge, canyon
hèn	coward
hẹn	set appointment
hên 	lucky
hèn hạ	despicable
hèn nhát	craven
heo	pig
hẹp	narrow
hẹp 	narrow
hẹp hòi	narrow minded
hét	yell
hết	to finish; to end
hết 	all, finish
hết hạn	expire
hết hơi	breathless
hét lên	scream
hết lòng 	wholeheartedly
hí	(of horse) to whinny; to neigh; of comedy
hỉ	blow one's nose; happy occasion
hiếm	rare
hiểm	dangerous; perilous
hiên	veranda
hiền	gentle, kind
hiện	appear, to come into sight
hiền 	nice and kind
hiến chương	chapter
hiện đại	modern
hiện đại hóa	modernize
hiện đến	appear to
hiện hình	appear
hiền lành 	nice, kind and good
hiện nay	presently, at the moment
hiển nhiên	evident, blatant
hiến pháp	Constitution
hiện tại	current, present
hiển thị	display
hiền từ	kind
hiện tượng	phenomenon
hiếp	to oppress, rape
hiếp dâm	rape
hiệp định	accord
hiệp hội	association
hiệp sĩ	chevalier, knight
hiệp ước	covenant, treaty
hiếu	pious; to be fond of
hiểu	comprehend, understand
hiệu	shop; store; label
hiệu đính	edit
hiệu đóng sách	bindery
hiểu không?	understand?
hiệu lực	potent
hiệu nghiệm	potent
hiểu nhầm	misunderstand
hiệu quả	effective, efficient
hiệu sách	bookstore
hiệu trưởng	dean
hình	shape, picture
hình 	figure
hình ảnh	image, picture
hình ảnh tưởng tượng	fantasy
hình bầu dục	oval
hình chữ chi	zigzag
hình chữ nhật	rectangle
hình dạng	shape
hình đĩa	discoid
hình nón	cone
hình phạt	penalty
hình sự	penal
hình tam giác	triangle
hình thức	form, formality
hình trụ	cylinder
hình vuông	square
ho	cough
hố	pit
hồ	lake
họ	they/them; family name
hộ	household; to help…for
hở	uncovered; gaping; open
ho 	cough
hố 	large hole in the ground
hồ 	lake
hớ 	blunder accidentally (overpay, over calculate)
hờ 	contingent, in case
hở 	slightly open 
hồ bơi	swimming-tank, pool
hộ chiếu	passport
hồ chứa	reservoir
hộ gia đình	household
họ hàng	relative
hớ hên	lucky by accident
hố phách	amber
hồ quang	arc
hồ sơ	file, documentation
hỗ trợ	backup, aid, assist
hoa	flower, floral
hoà	Republic
hóa	of chemistry; to change form into
hòa	to mix; to mingle; to dissolve; even; draw
hỏa	fire
họa	illustrated, bad news
hòa 	(a) draw, to dissolve
hòa bình	peace
hóa đơn	bill
hoà giải	conciliate
hòa giải	reconcile
hóa học	chemistry
hóa học trị liệu	chemotherapy
hoa hồng	rose
họa sĩ	painter
hòa tan	dilute, soluble
hóa thạch	fossil
hóa thân	incarnate, transform
hỏa thiêu	cremate
hoặc	or
hoặc là	either
hoài	always; continually; endlessly
hoàn	to return; to give back; to restore
hoãn	postpone, defer
hoạn	to castrate
hoàn cảnh khó khăn	plight
hoàn hảo	perfect
hoan hô	ovation, hail
hoan hô nhiệt liệt	great applause
hoan nghênh	applaud
hoàn thành	accomplish, fulfill, complete
hoàn toàn	entire(ly), complete(ly)
hoàn trả	refund
hoang	wild, uncultivated; uninhabited
hoảng	panic-stricken; to be in terror
hoang 	wild
hoang dã	wild
hoàng gia	royal
hoàng hôn	dusk, twilight
hoảng kinh	panic
hoảng sợ	panic, frighten
hoàng tử	prince
hoang vu	wilderness
hoành độ	abscissa
hoanh nghênh	acclamation
hoạt bát	bouncy
hoạt động	activity, operation
hoạt hình	animation
học	study, learn
học đọc	learn to read
học giả	scholar
hốc hác 	gaunt, haggard (look)
học nghề	learning vocation
học phí	tuition
học sinh	pupil
học thuyết	doctrine, school of thought
học tính	learn to calculate
học vẽ 	study to draw
học việc	apprentice
học viện	academy
học viết	learn to write
hoen	Spotted, stained
hói	bald
hôi	foul
hối	to repent; to regret; to press; to urge; to hurry
hồi	time; period; to cancel
hỏi	ask
hơi	vapor
hỡi	Dear, my dear (address an equal or inferior group); Oh…my dear..
hội	celebration
hối 	to regret, to urge
hơi 	slightly
hội chợ	fair, festival
hội đồng	council
hơi giống	akin, alike
hối hận	remorse
hối lộ	bribe
hối lộ 	bribery
hội nghị	conference
hơi nước	steam
hỏi rằng	asked
hơi rượu	whiff
hồi sức	analeptic
hội thảo	workshop
hơi thở	breath
hối thúc	to rush, hurry
hối tiếc	regret
hội trường	hall
hòm	ark, coffin
hôm	day
hợm	give oneself airs
hôm 	day
hôm nay	today
hôm qua	yesterday
hòn	a small round object (rock); classifier
hôn	kiss
hồn	soul
hỗn	mixed; impudent
hơn	more than, better than
hờn	sulk, resent
hỗn 	mixed, uncivil, impolite
hơn hết	most, above all
hỗn hợp	admixture
hỗn loạn	chaotic
hỗn loạn 	chaos
hôn mê	delirious, coma
hơn nữa	furthermore
hơn thế nữa	moreover
hóng	wait for; receive (cool air)
hòng	intend, aim; expect
hông	hip, flank
hỏng	bad, not working, spoil, fail
họng	throat
họp	meet(ing)
hộp	box
hợp	to suit; to fit; to accord
hợp 	compatible
hợp ca	chorus
hợp chất	compound
hợp đồng	contract
hợp kim	alloy
hợp lệ	valid
hợp lý	reasonable, logical, rational
hợp nhất	merge
hộp sọ	skull
hợp tác	cooperate, collaborate
hợp thành	composition
hộp thư	mailbox
hộp thức ăn	grub-box
hộp trà	caddy
hợp xướng	chorus
hợp, vừa	fit
hót	(of bird) to twitter
hốt	alarmed; to scoop up (with one's hands)
hột	seed
hớt bọt	skim
hột nhỏ	granule
hư	corrupt
hừ	Damn it!
hư 	corrupt, naughty, bad
hư hỏng	corrupt, decayed, rotten, spoiled
hú lên	howl
hứa	promise
hứa hẹn	engage, promises
huấn luyện viên	coach
hục	to addict oneself to
húc đầu	ram
huề	even, tie
huệ	lily (flower)
hủi	leprosy
hùm	tiger
hũm	puddle
hùng	hero, superman
hứng	motivated; to catch (falling object)
hung 	mean
hứng 	inspiration, spontaneous urge
hung ác	violent
hung dư	brutal
hung dữ	savage, aggressive and mean
hung hăng	rampant, aggressive and arrogant
hững hờ	aimless, careless about
hùng hồn	eloquently
hùng vĩ	mighty, breathtaking, grand
hương	incense; scent, perfume, fragrance
hưởng	to enjoy; to taste; to inherit
hướng 	direction
hướng bắc	north direction
hướng dẫn	instruct, guide
hướng đông	east direction
hưởng lợi	benefit, beneficiary
hướng nam 	south direction
hướng tây	west direction
hương thơm	flavor, perfume, scent
hương vị	taste, aroma
hướng xuống	downward
hươu cái	doe
hươu con	fawn
hươu đực	buck
hút	to suck in; lure, entice
hút bám	adsorb
hút cạn	depletion
hút thuốc lá	smoke
hữu	right (side)
hữu ích	useful, helpful
hủy	destroy
hủy bỏ	cancel
huy chương	medal
huy hiệu	crest
huy hoàng	splendid
huyền	jet-black
huyện	district
huyền bí	mysterious
huyên náo	uproar, ruction, disturbance, loud noises
huyền thoại	legend
huyết	blood
huynh	elder brother
huýt sáo	whistle
hy sinh	sacrifice
hy vọng	hope
ích kỷ	selfish
im	hush, quiet
im 	quiet
im lặng	silent
ít	little
ít hơn	less
ít nhất	least
ít xảy ra	infrequent
kẽ	crevice, opening
kế	scheme; stratagem
kẻ	3rd person (negative connotation)
kể	to tell; to relate
kệ 	shelf; to ignore
kẻ bại	loser
kẻ bắt giữ	captor
kẻ bất lương	rascal
kể cả 	including
kẻ chiến thắng	victor
kể chuyện	recitation, story telling
kẻ chuyên quyền	despot
kẻ cướp	robber
kế đó là	then is, next is
kẻ hành hạ	tormentor
kẻ hèn nhát	dastard
kế hoạch	plan
kể lại	narrate
kẻ lái xe	wheeler
kẻ lái xe chó	musher
kẻ làm con 	those who are children
kẻ lang bạt	journeyer, wanderer, vagabond
kẻ mắc lỗi	blunderer
kẻ man rợ	savage
kẻ móc túi	pick pocket
kẻ phản bội	traitor
kẻ quậy phá	antagonist
kẻ quê mùa	yokel
kẻ sống ở hang động	cave-dweller
kẻ tấn công	assailant, attacker
kẻ tham chiến	combatant
kẻ thù	adversary, emeny, foe
kẻ thù không đội trời chung	archenemy
kẻ tìm vàng	goldseeker
kế toán	accounting
kẻ tòng phạm	accomplice
kẻ trộm	thief
kể từ	since
kể từ khi	since
kẻ xâm lược	invaders, aggressor
kém	less, lacking
kẽm	zinc
kem đánh răng	toothpaste
kèm theo	enclose
kèn	trumpet, horn
kén chọn	fastidious
kênh	channel, canal, waterway
kênh mương	channel
keo	glue
kéo	pull, drag
kẹo	candy
kẹo cao su	gum
kéo dài	long-drawn, prolong
kéo mạnh	tug, jerk
kẹp	clip, clamp
kết	tie in knots; collect gather; conclude, wind up
kẹt	jam, get stuck
kết 	to link, to comnplete/end
kết án	convict
kết cục	denouement
kết hôn	marry
kết hợp	conjoint, combine
kết lại với nhau	cohere
kết luận	conclusion
kết nối	connect
kết quả	result
kết thúc	end, finish, conclude
kết trực tràng	colon
kết tủa	precipitate
kêu	exclamation
kêu 	call
kêu ẳng ẳng	yelp
kêu la	shout, clamor, roar
kêu lạch cạch	rattle
kêu lên	exclaim
kêu the thé	shrill
kêu van	moan and plead
kêu vang lên	din
khá	quite, fair
khả năng	ability
khác	other, different
khắc	engraving
khạc	clear throat out
khắc 	engrave
khác biệt	differ
khắc nghiệt 	harsh
khác nhau	different
khạc nhố	spit
khác thường	unusual, strange
khách	guest
khách hàng	client, customer
khách sạn	hotel
khai	declare
khai báo	declare
khai hoang	explore and reclaim land
khái niệm	concept
khai trí	edify
kham	to bear; to endure
khám phá	discover, explore
khan	husky; raucous; hoarse
khăn	towel, handkerchief, scarf
khấn	to pray
khẩn	to reclain (waste land)
khẩn 	emergency, call for help
khẩn cấp	urgent, emergency
khán giả	audience
khăn giầu	wrapped bag hang by the shoulder
khan giọng	hoarse
khan hiếm	scarce
khẩn khoản 	pleading
khẩn khoản yêu cầu	appeal
khăn tay	handkerchief
khăn trải giường	bed cover
khẳng định	definitely confirm
khánh	musical stone
khánh thành	inauguration
khao khát	aspire
khảo sát	survey
khắp	throughout
khát	thirst
khát khao	desirous
khâu	sew
khẩu hiệu	watchword
khấu trừ	deduct
khe	slot, slit
khế	contract; greement; a starfruit
khen	compliment, praise
khen ngợi	commend, praise
khen thưởng	reward
khéo	crafty, skillful
khéo léo	skillful
khét tiếng	notorious
khi	when, during, while
khí	gas
khỉ	monkey
khí 	air gas
khi đó	meantime, at that time
khí động lực	aerodynamic
khí hậu	climate
khi nào	when
khí nitơ	nitrogen
khía cạnh	aspect, angle, point of view, perspective
khích	encourage
khiếm khuyết	defect
khiêm tốn	humble, modest
khiến	to order
khiến 	cause to
khiển trách	criticize
khiếp 	frightened
khiếp đảm 	frightened
khiêu	to rouse, to stimulate
khiếu nại	complaint
khiêu vũ	dance
khinh	contempt, disdain, to despise
khinh 	contempt, look down
khinh khi	despise
khinh miệt	scorn
khịt mũi	snort
kho	depot
khó	difficult, hard
khô	dry
khố	loin-cloth
khố 	miserable
khô cằn	parched
khó chịu	unpleasant, nasty
kho chứa	storage
kho chứa vũ khí đạn dược	arsenal
kho hàng	warehouse
khó hiểu	difficult to understand, ambiguous
khó khăn	hard struggle
khô khan	arid
khó khăn hơn	harder
khó khăn nhất	hardest, toughest
kho lương thực	commissary
khó nhọc	toil, difficult work
khó quên	unforgetable
khổ sở	miserable
khô teo đi	crisp
khó tiêu	dyspeptic
khoa	faculty, course, subject
khóa	lock, buckle, Key
khoa học	science
khóa học	course
khoa răng	dentistry
khỏa thân	naked, nude
khoa tiết niệu	urology
khoác lác	bluster
khoai	root starch vegetable, potato; sweet potato
khoái	pleased; satisfied; joyful
khoai lang	yam
khoai tây	potato
khoan	broach
khoản	term
khoản 	term, item, article, clause
khoang	hold (of boat)
khoảng	approximately, about
khoang 	to drill, a cargo hold(of boat, ship, train)
khoảng 	about
khoảng cách	distance, gap
khoáng sản	mineral
khoảnh	plot of land
khoanh 	to draw a circle, a round piece of
khoảnh khắc 	split second
khóc	cry
khốc	intense; very (dry)
khốc liệt	fierce
khốc liệt hơn	fiercer
khóc nức nở	sob
khoe	to brag; to boast; to show off
khỏe	healthy
khoe khoang	bluster, boast, brag
khoét	carve a hole
khói	smoke
khối	chunk, block, batch, block
khỏi	from, away from
khởi	start
khởi 	start
khởi đầu	beginning
khởi động	start, initiate
khôi hài	funny
khối lượng	volume
khối lượng công việc	workload
khôi phục	restore
khom	bend back
khóm	pineapple
khôn	wise
khốn	in a crisis
khốn khố	miserable
khốn kiếp	damn
khôn lớn lên	grow up
khôn ngoan	wise, prudent
không	no
không 	not, do not
không ai	nobody
không bao giờ	never
không bị	is not (affected)
không bị ảnh hưởng	(to be) untouched, unaffected
không bị nao núng	(to be) uncowed
không bị nghi ngờ	(to be) unsuspected
không bị quấy rầy	(to be) unmolested
không bị thay đổi	(to be) unaltered
không bình thường	anomaly, unsual
không cái nào	none
không cảm động	inexorable
không cần phải	don't need to
không chải chuốt	unkempt
không chịu được	intolerable
không chơi 	do not play
không có	without, do not have (something)
không có cái gì	nothing
không có gì	nothing
không có tóc	hairless, bald
không cương	unbridled
không đáng tin cậy	dubious, untrustworthy
không dây	wireless
không đều	irregular
không đối	constant
không đồng đều	uneven
không đồng ý	disagree
không đúng	incorrect
không được thuần hóa	(to be) ill-tamed
không dứt	unending
không gian	space
không hạnh phúc	uncontent
không hiếu kỳ	incurious
không hòa hợp	discordant
không khí	ambiance, atmosphere, air
không lai	pure bred
không làm	don't
không làm hại	inoffensive
không lay chuyển	unswerving
khống lồ	enormous, giant, huge
không màu	achromatic
không may	unlucky
không mong đợi	unexpected
không mong muốn	unwonted
không ngừng, luôn, suốt, vĩnh viễn	perpetual
không nhìn thấy	unseen
không nơi nào, không ở đâu	nowhere
không phải là	is not
không quân	air force
không rõ ràng	unknown
không sợ hãi	fearlessly
không tán thành	disapprove, disagree
không thấm nước	waterproof
không thể	cannot, unable
không thể hiểu được	incomprehensible
không thể nào quên	unforgettable
không thể tách rời	inseparable
không thể thiếu	indispensable
không thể tránh khỏi	inevitable
không thích hợp	unfit
không thỏa đáng	unsuitable, unsatisfactory
không thực tế	unrealistic
không thương tiếc	merciless
không tiêu	indigestible
không tin	unbelieve
không ưa	dislike
không vừa lòng	not pleased
không vui	unhappy
không xác định	unidentified
khu	region
khu 	region, area
khu vực	area, district, region, zone
khua	to strike; to beat (an instrument)
khuân	to carry
khuất	hidden
khúc	part, section
khúc gỗ	log
khúc gỗ mới đốn	log
khuếch đại	amplify
khuếch tán	diffuse
khung	frame
khủng bố	terror
khủng hoảng	crisis
khủng khiếp	horrible, awful, abysmal
khủng long	dinosaur
khung vẽ	easel
khước từ	deny
khuôn 	mold
khuôn mặt	face
khuôn viên trường học	campus
khuya	late
khuyên	recommend
khuyên bảo	advise
khuyến khích	encourage
khuyết	defects, flaw
khuyết điểm	flaw, weakness
khuyết tật	handicapped
khuỷu	elbow
khuỷu tay	elbow
kia	other
kìa	that
kịch 	drama
kịch bản	script
kích cỡ	size
kích cở	size
kích động	provoke
kích hoạt	activate
kích thích	irritate, excite, stimulate
kích thước	size, dimension
kịch tính	dramatic
kiếm	sword; search
kiềm chế	refrain, curb
kiểm duyệt	censor
kiểm kê	collect cencus, inventory
kiểm lại	recount
kiểm soát	control
kiểm toán	audit
kiểm tra	test, check, examine
kiểm tra thứ tự	collate
kiến	ant
kiện	to sue; package; event
kiện 	to sue, a package
kiên gan	persist
kiến nghị	petition
kiên nhẫn	patience
kiến thức	knowledge
kiên trì	resilient
kiến trúc	architecture
kiến trúc sư	architect
kiêng	abstain
kiêng cữ	abstinent
kiếp	life; generation
kiếp sau	afterlife
kiệt	exhausted, worn out, clean out
kiệt sức	completely worn out
kiêu	arrogant; proud; haughty
kiếu	decline to come, decline attend
kiểu	manner
kiệu	carriage, palanquin
kiêu căng	arrogant
kiêu hãnh	pride
kiêu hảnh 	arrogant
kiêu ngạo	pompous
kilômét	kilometers
kim	needle, metal
kim cương	diamond
kim loại	metal
kín	closed, secret; private
kín 	sealed, closed, hidden
kín đáo	discreet
kín gió	airtight
kinh	religious text; (short for)fear
kính	glasses
kinh 	horrifying, bible (words)
kính đeo mắt	eyeglass
kinh dị	horror
kinh doanh	venture, business
kinh hãi	aghast
kính hiển vi	microscope
kinh hoàng	frighten, shock, stunned
kính nể	respect highly
kinh ngạc	astonish, shock and surprise
kinh nghiệm	experience
kinh sợ	dread, awe
kinh tạ ơn	benediction
Kinh Thánh	bible, scripture
kinh tởm	disgust
kịp	on time
Kitô	Christ
ký	to sign, kí(kilogram)
kỳ	incidence
kỹ	careful; painstaking
kỷ	small table
kỵ binh	cavalry
kỳ cựu	veteran
ký hiệu	denotation
kỷ luật	discipline
kỹ luật 	discipline
kỷ luật tự giác	self-discipline
kỹ lưỡng 	careful
kỹ năng	skill
kỳ nghỉ	vacation, holiday
kỷ niệm	memory, commemorate
kỳ quái	eerie
ký sinh trùng	parasite
kỹ sư	engineer
kỳ thi vấn đáp	quiz
kỹ thuật	technical
ký túc xá	dormitory
la	to shout; a mule
lá	leaf
là	is/are, equal to
lã	plain (water)
lả	exhausted
lạ	strange, weird
la 	yell
la bàn	compass
la cà 	loiter, linger, wander
lá cờ	flag
la hét	scream
lạ lùng	queer, strange, perculiar
la mắng	scold
lá phiếu	ballot
là thói thường	wonted
lá thư từ chức	resignation letter
là ủi	iron
lắc	shaken
lạc	to lose trace; to stray; to misplace
lạc đà	camel
lạc đề	digress
lạc hậu	old-fashioned, backward
lắc lư	to rock (motion)
lắc mạnh	agitate
lạc quan	optimistic
lách	spleen; to dodge; to swerve
lạch	creek
lách 	spleen
lai	crossbred
lài	slight sloped; Jasmine
lãi	interest
lại	again, return, around
lai 	crossbred, mix breed
lái 	drive
lãi suất	interest
lái xe	drive a vehicle
lái xe chó	drive sled dog 
lam	indigo-blue; deep blue
làm	do, make, cause
lăm	number 5 ending of a multiple digits (ex: 15, 25..)
lấm	stained
lầm	mistaken
lắm	very, many 
làm ấm	cosy
lẩm bẩm	mumble
làm bắn	splash
làm bẩn	smudge, befoul
làm bị thương	injure
làm biến dạng	deform
làm bối rối	discomfit, baffle
làm bớt	allay
làm cáu kỉnh	disgruntle
làm cháy sém	scorch
làm chệch hướng	deflect
làm cho buồn phiên	aggrieve
làm cho đầy lại	refil
làm cho phù hợp	match
làm chủ	own
làm chứng	testify, witness
làm đánh lạc hướng	distract
làm đau đớn	afflict
làm đen	blacken
làm dịu	soothe
làm đố	spill
làm đố nát	dilapidate
lạm dụng	abuse
làm gãy	break(up)
làm gì	what for(at the end of sentence)
làm giảm	reduce, detract
làm giảm bớt	alleviate
làm giảm độ ẩm	dehumidify
làm giãn	stretch
làm giàu	enrich
làm giẩy nảy người	electrify
làm hoảng sợ	frighten
làm hỏng	ruin
làm hư hỏng	spoil
làm khiếp sợ	awesome
làm khô nẻ	parch
làm kinh ngạc	amaze
làm lạnh	chill
làm lễ kỷ niệm	celebrate, commemorate
làm lóa mắt	dazzle
làm loãng	dilution
làm lu mờ	tarnish, efface
làm lúng túng	abash
làm mất nước	dehydrate
làm mất ốn định	destabilize
làm mất thể diện	abase, lose face
làm mới	renew, refresh
làm nặng thêm	aggravate
làm ngạc nhiên	astonish
làm ngập nước	drowse
làm nghẹt thở	choke
làm ngớ ngẩn	befuddle
làm ngột thở	smother
làm ngừng hoạt động	deactivate
làm nguội	to cool
lảm nhảm	babble
làm nhột	tickle
làm nhục nhã	reproach
làm ốm đau	ail
làm ơn	please
lạm phát	inflation
làm phát ngấy	cloy
làm phật ý	vexation, make someone not pleased
làm phiền	bother, annoyance
làm phiền muộn	depressed
làm quen	acquaint, accustom
làm rõ	clarity, clarify
làm rối	tangle
làm rung chuyển	convulse
làm sạch	purify
làm sai	botch
làm sáng	lightening, brighten
làm sao	how
làm sao thế	alright?
làm sao?	how?
làm sâu sắc	deepen
làm say đắm	captivate, bewitch
làm se	astringent
làm sống lại	revive
làm suy giảm	depress
làm tan	thaw
làm tăng thêm	augment
làm táo bón	constipate
làm tê liệt	numb
làm thành thô	coarsen
làm thất vọng	deject
làm thế nào	how
làm trật bánh	derail
làm trầy	abrade
làm tròn	rounding off
làm trọn	acquit
làm trục trặc	derange
làm u ám	darken
làm ướt sũng	drench
làm vất vả	drudge
làm vệ sinh	sanitate
làm việc	work
làm vui	amuse
làm yếu đi	weaken
lan	spread
lăn	roll
lần	(a) time, incidence
lằn	stripe, line mark, lane
lẫn	doting; forgetful
lẩn	hide, avoid
lặn	dive
lặn 	dive
lan can	banister
làn đường	lane
lần lượt	one by one 
lan rộng	widespread
lan tràn	overrun, overflow
lẫn vào	mingle
lang	wild dog
láng	smooth; glossy
làng	village
lăng	shrine
lắng	(of liquid) to deposit, to settle
lảng	to slip away; to sneak away; to turn away
lặng	silent, calm
lắng 	settle down
lặng 	settle down
lang bạc	wandering
lãng phí	waste
lang thang 	wandering
lãng trí	forgetful
lanh	quick, sharp (behavior)
lành	kind, well, healed
lạnh	cold
lành 	good natured
lãnh đạo	to lead
lạnh giá	frosty
lạnh hơn	colder
lanh lẹ	alert, agile
lạnh lẽo	chilly
lạnh lẽo 	cold
lanh lợi	shrewd
lạnh lùng	stern, cold
lành mạnh	wholesome
lãnh sự	consular
lãnh sự quán	consulate
lãnh thố	territory
lảnh thổ	demesne
lao	plunge
láo	lie
lào	Laos
lão	old
lao động	labor
lao vào	plunge, to rush in
lao xuống	dive
lấp	fill
lắp	install
lập	organize, founding, form
lấp 	fill
lập 	to form (a group, company...)
lấp đầy	fills
lập dị	eccentric
lặp lại	repeat
lấp lánh	sparkle, glitter
lắp ráp	reassemble
lát	pave
lạt	plain (taste)
lặt	to pick off vegetable leaves
lật đổ	overthrow
lát, miếng mỏng	slice
lau	wipe
làu	long
lâu	a long time
lâu dài	enduring
lâu/dài	long
lâu/dài hơn	longer
láy	to repeat; to reiterate
lây	contagious
lấy	fetch, take, get
lầy	swampy
lạy	to kowtow
lay động	dither
lấy được	derive
lấy lại	retrieve, regain
lây lan, tỏa lan	spread
lầy lội	boggy
lây nhiễm	infect
lấy vợ	get married
lê	pear; to drag on the ground
lẽ	reason
lề	margin, side edge
lễ	ceremony
lẻ	single, odd in number, alone
lệ	tear; regulation
lề đường	wayside
lễ hội	festive
lễ kỉ niệm	memorial
lễ kỷ niệm	anniversary
lễ kỷ niệm một trăm năm	centenary
lẽ phải	right reasons
lệ phí	fee
lễ rửa tội	baptism
lệch hướng	wrong way
lệch lạc	deviant
lem	to smudge; dirty
len	wool; to move among
lên	up
lẻn	sneak
lên 	up/on to
lên án	denounce, condemn
lên cao	surging
lên dây	windup
lên dốc	uphill
lên giường	go to bed
lên ngôi	accession
lên trên	aboard
lên trời	skyward
lệnh	command
lệnh giới nghiêm	curfew
leo	climb, creep
lẽo	not straight ; unstraight
lẻo	climb; to cut neatly
lết 	to drag oneself on the ground
lều	tent
lều 	tent
lêu lống 	idle, wandering about
lều?	tent?
lìa	cut off
lịch	calendar
lịch sự	polite
lịch trình	schedule
liếc qua	glance
liếm	lick
liềm	sickle, reaping-hook
liếm 	lick
liền	consecutive; (of wound) to heal; to skin over
liên hệ	contact
liên hợp	conjugate
liên kết	link, conjunction
liên lạc	communicate
liên minh	confederate, alliance, coalition
liên quan	relevant, concern, relate
liên quan đến	concerning
liên tiếp	continuity
liên tục	continuous, constant
liệng 	throw
liệt 	paralyze, to list
liệt giường	bedfast
liều	dosage
liệu	data; to manage; to calculate
liều (thuốc)	dose
liều lượng	dose
liệu, dù	whether
lim	ironwood
lính	soldier
lính cứu hỏa	fireman
lính cứu thương	medic
linh hoạt	versatile, flexible
linh mục	priest
lính trinh sát	scout
lĩnh vực	field, realm
lo	to bother; to worry; to attend to
lô	lot, parcel
lố	hole
lỗ	hole
lơ	to dissemble; to ignore
lọ	jar, vase
lờ	to pretend not to know; to cut
lỡ	to miss; to fail; to lose
lở	have a skin eruption, rash, eczema
lo 	worry
lộ 	street, to be discovered
lo âu	anxious, worry
lờ đi	overlook
lô hàng	parcel of good
lô hội	aloe
lo lắng	anxious, worry
lơ lửng	floating back and forth, undecisive
lỗ mãng	blunt
lò mố	butchery
lờ mờ	bleary
lỗ mũi	nostril
lò nướng	bakery
lò sưởi	fireplace
lố tai	ear
lỗ thông hơi	vent
lo tính 	concern
lô trống	vacant lot
lò xo	a springing coil
loa	speaker; horn; megaphone
lòa	dim
loài	kind; gender ; specied
loại	assortment, kind
loài 	specied, kind
loại bỏ	discard, eliminate, rid, remove
loài gây hại	pest
loài giống	breed
loài linh dương	antelope
loại trừ	exclude
loạn	to be in disorder
loạn 	chaos
loáng	flash, (of time) fly by, pass swiftly
loạng choạng 	staggered
lóc	to dissect; to cut up
lộc	(bot) bud
loè	to bluff
lóe 	flash
lóe lên	flare
lóe sáng	flash
loét	ulcer, (infection) eaten up
lôi	to pull, to drag
lõi	core
lối	style; way; manner
lồi	bulge out; prominent
lỗi	error, fault
lời	words, profit
lội	to swim; to wade
lợi	beneficial; to do good to
lợi 	interests
lời bình luận	commentary
lời cầu xin	plea
lời chào tạm biệt	good bye
lời chia buồn	condolence
lôi cuốn	fetching, pull in, attracting
lời giới thiệu	introduction
lời hứa	promise
lời hứa hôn	engagement promise
lợi ích	benefit
lời khen	compliment
lời khuyên	advice, counsel
lồi lên	bulging
lời mời	invitation
lời nguyền	curse
lời nhạc	lyrics
lời nhắc nhở	reminder
lợi nhuận	profit
lời nói đầu	preamble
lối ra	egress, exit
lợi thế	advantage
lỗi thời	outdated
lôi thôi 	untidy, unorganized
lời tiên đoán	divination, prediction
lời tuyên thệ	oath
lối vào	entrance
lõm	deep-set; sunken (eyes)
lốm đốm 	covered with spots
lớn	massive, big, large
lộn	to mistake; to confuse; to confound
lợn	pigs
lớn hơn	larger, greater
lớn lên	grow
lợn lòi đực	boar
lớn trưởng thành	full-grown
lộn xộn	mess, fuss, unorganized, problematic
lòng	lap
lông	fur
lồng	cage
lỏng	liquid
lọng	parasol
lòng biết ơn	gratitude
lông chim	quill, feather
lông gáy	mane
lòng ham muốn	lust, hunger for
long lanh	glitter
lóng lánh như bạc	silvery
lộng lẫy	splendid
lỏng lẻo	loose
lông mày	eyebrow
lông thú	fur
lòng thương	compassion
lòng thương xót	mercy
lông tiếng	dub
lòng trung thành	allegiant
lòng 	heart; soul; mind
lông, tóc	hair
lốp	tire
lớp	course, class, grade, level
lợp	to cover; to layer (a roof)
lớp học	classroom
lớp vỏ	crust
lọt	to fall into
lột	to skin; to peel off
lọt lòng	just out of womb
lột trần	denude
lũ	a crowd, flood, (group classifier put-down)
lư	urn
lữ đoàn	brigade
lũ lụt	flood
lũ trẻ	kids
lúa	(bot) rice; paddy
lụa	silk
lừa	fool, trick
lửa	fire
lừa 	to trick, a donkey
lửa 	fire
lừa bịp	deception
lựa chọn	choose
lừa đảo	abusive
lừa dối	delude, cheat
lừa gạt	deceive
lúa mạch	barley
lúa mì	wheat
lửa mừng	bonfire
lứa tuối	age
lùa vào bãi quây	corral
luận	essay
luận cứ	argument
luật	law; rule; code; regulation
luật 	law
luật chung	general rule
luật đa số	majority rule
luật sư	lawyer, attorney
lúc	at; moment; while
lực	force; strength
lực 	force, strength
lục địa	continent
lực hấp dẫn	attraction
lúc lắc	wag
lực lượng	force
lực lượng không quân	air force
lúc nào 	at which time
lui	back; to move back; to fall back
lủi	to slip a way
lụi	get stunted, wither away
lùi 	back
lùi lại	aback
lùi trở lại	aback
lúm đồng tiền	dimple
lùn	dwarf
lùng	scour
lưng	back 
lừng	resound
lung linh	flickering, dreamlike
lung tung	desultory, all over the place
luộc	boiled
lược	to prune; to baste
lưới	grid; net
lười	lazy; slothful
lưỡi	tongue, blade (sharp object)
lười 	lazy
lười biếng	lazy
lưỡi lê	bayonet
lưỡi liềm	crescent
lười nhác	to loaf
luôn	always, perpetual
luồn	threaded; to pass through
lượn	to soar; to hover; to glide
luồn 	to pass through by lower the body
luôn luôn	always
luống	vegetable and plantation bed/row
luồng	jetstream flow of air/wind/water
lương	salary; pay; wage
lượng	quantity
luồng 	flow stream
lưỡng cực	dipole
luồng gió	wind flow
lương hưu	pension
luồng khí	airflow
luồng khói	smoke flow
lương tâm	conscience
lương thực	ration
lướt	glide
lượt	time; turn
lượt 	a turn/instance , to filter
lụt	flood; inundation
lưu	save
lưu đày	exile
lưu thông	circulatory
lưu trữ	store
lưu vực	basin
lũy	rampart
luyến	long for, be reluctant to part with (to leave)
luyện	to train; to drill
luyện 	to train
luyện chó	dog-breakin'
ly	glass
lý	reason; ground
ly dị	divorce
lý do	reason
ly hôn	divorce
ly hợp	clutch
lý luận	logical reason(ing),
lý tưởng	ideal
ma	phantom
má	cheek, mother 
mà	that, which
mã	code
mả	tomb; grave
mạ	rise seeding 
mà 	that
ma quỉ	fiend
ma quỷ	diabolic, devil
mã số	code
ma tuý	narcotic
mắc	busy; occupied; engaged
mạc	screen ; curtain
mặc	wear; to ignore
mắc 	expensive, stuck with
mặc cả	bargain
mặc định	default
mặc dù	despite, although
mặc kệ	who cares, just ignore/leave (one)
mặc kệ 	ignore(d)
mặc khải	revelation
mặc quần áo	put on clothes
mách	to sneak; to tell tales
mạch	pulse
mạch lạc	coherent
mai	tomorrow; carapace; spade
mái	roof
mài	to whet ; to sharpen
mãi	 a long time; always for ever; for good; unceasingly, all the time; all the way
mái 	roof
mãi 	continuously
mái chèo	oar
mại dâm	prostitute
mãi mãi	forever, eternal
mài mòn	abrasion
mái nhà	house roof
mái vòm	dome
mâm	tray
mầm 	germ seed, bud
màn	rug
mận	plum
màn hình	screen
man rợ	savage, barbaric, barbarian
mãn tính	chronic
mang	bring, carry
máng	ditch
măng	bamboo shoot
mắng	chide
mảng	array
mạng	web
mang 	carry
mạng che mặt	veil
mang lại	bring
mạng lưới	net
mắng mỏ	berate
màng ngăn	diaphragm
mạng nhện	cobweb
màng nhĩ	eardrum
mang thai	pregnant
mảnh	piece
mạnh	strong
mánh khóe	trick
mảnh mai	slender
mạnh mẽ	vigorous, drastic, powerful, robust
manh mối	clue
mảnh vụn	wreckage, debris, splinter
mao	hair, fur (lông mao)
mào	comb; crest (of bird)
mạo hiểm	adventurous
mao mạch	capillary
mập mờ	ambiguous
mát	cool
mất	loss
mắt	eye
mạt	mites
mật	bile
mặt	face
mắt cá chân	ankle
mặt đất	ground
mặt đen	black-faced
mắt đỏ	red-eyed
mắt kính	eye glass
mặt lò sưởi	mantel
mát mẻ	cool
mắt nhìn 	eyes look
mật ong	honey
mất tinh thần	dismay, mentally set back
mặt trăng	moon
mất trí	demented
mặt trời	sun
mau	quick
máu	blood
màu	color
mẫu	specimen, sample
mẫu Anh	acre
màu be	beige
màu da cam	orange
màu đen	black
màu đỏ	red
màu đỏ tươi	scarlet
màu đồng	bronze
màu hồng	pink
màu mỡ	fertile
màu nâu vàng	auburn
màu sắc	color
màu tía	purple
màu trắng	white
màu vàng	yellow color
mẩu vụn	crumb
màu xám	gray
màu xanh	blue
màu xanh lá cây	green
máy	machine
mày	you
mây	cloudy
mấy	how much; how many; what; how?
may 	sew
mấy 	some
máy bay	aircraft, airplane, plane
máy chụp ảnh	camera
máy cưa lớn	saw-mill
máy đếm	counter
máy dò	detector
máy giặt	washer
máy kéo xích	caterpillar
may mắn	luck
máy may	sewing machine
máy nén	compressor
máy rửa bát	dishwasher
máy tính	calculator, computer
máy tính xách tay	notebook
mé	edge; border
mê	to faint; to lose consciousness
mẻ	chipped
mẹ	mother
mẹ chồng	husband's mother
mê mẩn	dote, infatuated
mê sảng	delirium
mẹ vợ	wife's mother
mềm	squishy, soft
mềm hơn	softer
mến	to love; to like; to be fond of
mến yêu 	love
mệnh	lot, fate; fortune
meo	musty
mèo	cat
mèo con	kitten
mèo hoang	wildcat
mép	edge; border ; margin
mép 	edge, border
mép bàn	edge of the table
mệt	tired; fatigued; weary 
mệt 	tired, exhaust
mệt mỏi	weary, wan, fatigue
mí	edge
mì	noodle
mí mắt	eyelid
mía	cane
miễn	to exempt; to excuse; to forgive
miễn cưỡng	reluctant
miễn nhiệm	dismiss
miễn phí	free, no charge
miễn thuế	exempt, tax free
miễn trách nhiệm	absolve
miếng	piece
miệng	mouth
miếng 	piece, a bite
miếng da bao cố tay	wristband
miếng gố	piece of wood
miệng núi lửa	crater
miếng to	dollop
miếng vụn	crumb
miết	jam
miếu	temple; shrine
miêu tả	depict
mịn	smooth
mình	me, you, we(us) between close friends or endearing pronoun to a lover or spouse
minh họa	illustrate
mít	jack
mô	tissue
mõ	wooden bell, bamboo tocsin
mố	peck
mồ	tomb; grave
mỏ	mine, beak
mớ	cot; to talk in one's sleep
mờ	blur, blurry
mỡ	fat; grease
mộ	grave
mở	open
mợ	aunt (wife of mother's younger brother)
mơ 	dream, apricot (fruit)
mớ 	a bunch of, sleep talking
mồ côi	orphan
mô của cơ bắp	tissue
mở đầu	prelude
mở hé	ajar
mô hình	pattern
mơ hồ	vague
mơ hồ 	vague
mò mẫm	grope
mờ mịt	dreamy
mơ mộng	daydream
mỏ neo	anchor
mờ nhạt	faint
mờ nhạt nhất	faintest
mô phỏng	simulate
mở ra	open
mở rộng	open wide, broaden, expand, extend
mô tả	descriptive, describe, description
móc	hook; crotchet; clasp
mốc	landmark
mọc	uprise
mộc	acoustic
môi	lip
mối	termite
mồi	bait
mỗi	every, each
mỏi	weary, tired
mọi	all; every
mới	new, just(happen)
mời	invite
mỏi 	weary
mọi 	all
mới 	new, just (action)
mối ác cảm	grudge
mới bắt đầu	just begin
mối đe dọa	threat
môi giới	brokerage, broker
mối hàn	weld
mối lo âu	anxiety
mỏi mòn	worn-out
mới nên	right thing
mối nguy	hazard
mối nguy hại	mischief
mới nhất	last
mối nối	junction
mối quan hệ	relationship
môi trường	environment, surrounding factors
mới vừa	just (happen)
mõm	snout; muzzle
mồm	mouth
mồm đọc	read mouth
món	item
mòn	to wear
môn	band, gang, elique
mọn	tiny, very small
món ăn	dish
môn đồ	disciple
món nợ	debt
món tráng miệng	dessert
mong	hope
móng	nail
mông	buttock
mỏng	slim, thin
mong 	hope
mộng 	a dream
móng chân	toe nail
mong đợi	expect
mong manh nhất	most fragile
mong muốn	desire
mốt	mode
mọt	wood-borer; woodeater
một	a, one 
một cách	in a (adjective) way; adverb
một cách ác ôn	grimly
một cách an toàn	securely, safely
một cách an ủi	appeasingly
một cách bằng nhau	equally
một cách bất thường	unusually
một cách bí mật	secretly
một cách bình tĩnh	calmly
một cách bộc trực	plainly, directly
một cách buồn bã	sullenly
một cách cấm tuyệt	forbiddingly
một cách can đảm	bravely
mọt cách cẩn thận	gingerly, carefully
một cách cần thiết	necessarily
một cách cảnh giác	keenly
một cách cao	highly
một cách chắc chắn	securely, solidly
một cách cô đơn	lonely
một cách cố ý	deliberately
một cách công khai	openly
một cách đặc biệt	particularly, specially
một cách đắc thắng	triumphantly
một cách đau đớn	painfully
một cách đầy đủ	fully
một cách dễ dàng	easily
một cách đe dọa	menacingly
một cách đè nén	suppressedly
một cách đê tiện	despicably
một cách đều đặn	steadily, consistently
một cách điên cuồng	madly
một cách đơn giản	simply
một cách đột ngột	suddenly
một cách đứng đắn	seriously
một cách ê chề	sorely
một cách e thẹn	sheepishly
một cách giận dữ	furiously
một cách hân hoan	joyfully, gleefully
một cách háo hức	eagerly
một cách hào hứng	excitedly
một cách hào phóng	generously
một cách hấp dẫn	appealingly, attractively
một cách hiểm ác	wickedly
một cách hiếm hoi	rarely
một cách hoàn toàn	completely
một cách huyên náo	uproariously
một cách khôn ngoan, tính toán	shrewdly
một cách không thương tiếc	mercilessly
một cách khủng khiếp	horribly
một cách kiên cố	fortified solidly
một cách kiên quyết	resolutely
một cách kín đáo	slyly
một cách kinh khủng	frightfully
một cách kịp thời	promptly
một cách lạ lùng	strangely
một cách lạnh lùng	coldly
một cách lặp đi lặp lại	repeatedly
một cách liên tục	constantly, continually
một cách lờ mờ	dimly, shadily
một cách lỏng lẻo	loosely
một cách ma quái	ghostly
một cách man rợ	savagely
một cách mãnh liệt	crushingly
một cách mạnh mẽ	mightily
một cách mau lẹ	speedily
một cách mềm mại	softly
một cách miễn cưỡng	involuntarily
một cách mịn	finely
một cách nặng nề	heavily
một cách ngay thẳng	plainly, directly
một cách nghi ngờ	dubiously
một cách nghiêm trọng	gravely
một cách ngố nghịch	unruly
một cách ngoan ngoãn	docilely
một cách nhân nhượng	appeasingly
một cách nhanh chóng	rapidly, swiftly
một cách nhẹ nhàng	gently
một cách nhiệt tình	enthusiastically
một cách nhục nhã	shamefully
một cách nồng nhiệt	warmly
một cách ốn định	steadily, settled
một cách phản bội	treacherously
một cách phấn khởi	exultantly
một cách placatingly	placatingly
một cách quyết liệt	fiercely
một cách sắc bén	sharply
một cách sang trọng	luxuriously
một cách suất xắc	remarkably
một cách tàn ác	savagely
một cách thân thiện	friendly
một cách thận trọng	warily, cautiously
một cách thành thật	truly, sincerely
một cách thiếu suy nghĩ	thoughtlessly
một cách thoải mái	comfortably
một cách thường xuyên	frequently
một cách tinh khôn	cunningly
một cách tính toán	in a calculating way
một cách tinh xảo	craftily
một cách to lớn	greatly
một cách tò mò	curiously
một cách tròn trặn	roundly
một cách trực tiếp	directly
một cách trung thành	faithfully
một cách trung thực	honestly
một cách tự nhiên	instinctively
một cách tự tin	confidently
một cách từ từ	slowly
một cách từ xa	remotely
một cách tương đối	comparatively
một cách ung dung	coolly
một cách vô ích	futilely
một cách vô tình	unwittingly, heartlessly
một cách vô vọng	abjectly, hopelessly
một cách vô ý	accidentally
một cách vu vơ	aimlessly
một cách vuông vắn	squarely
một cách xuất sắc	preeminently
một cách xứng đáng	worthily
một cách yếu ớt	weakly
một cái gì đó	something
một chút	a bit
một gia tộc	a family
một hàng	a row
một hôm	one day
một lần	one time, once
một lần nữa	again
một loại dâu	berry
một lớp	a class
một mình	alone, oneself
một nửa	half
một phần	part
một số	several, some
một tá	dozen
một vài	some
một vài nơi	a few places
mù	blind
mũ	hat; cap; bonnet
mủ	mother
mù 	blind
mù tạt	mustard
mua	purchase, buy
mùa	season
mưa	rain
mùa đông	winter, wintry
mưa rào	downpour
mùa thu	autumn
mưa tuyết	sleet
mùa xuân	spring season
múc	scoop, ladle soup out into bowls
mục	section
mực	squid
mục 	an article section, to rot(wood, bone...)
mục đích	purpose, aim
mục nát	corrupt
mục rữa	decay
mục sư	pastor
mục tiêu	target, objective
mùi	odor, smell
mũi	nasal, nose
mũi đất	cape
mũi nhọn	wedge
mùi tanh	fishy smell
mũi tên	dart, arrow
mũm mĩm	chubby
mụn có	wart
mụn trứng cá	acne
mừng	to rejoyce; to congratulate
mừng 	greet
muối	salt
muỗi	mosquito
mươi	(denoting the tens)
mười	ten
mười 	ten
mười ba	thirteen
mười bảy	seventeen
mười bốn	fourteen
mười chín	nineteen
mười hai	twelve
mười năm một lần	decennial
mười sáu	sixteen
muôn	ten thousand
muốn	want
muộn	tardy, late
mướn	to hire; to rent
mượn	to borrow
mương	trench
mụt	boil
mứt	jam, sugar-coated fruit, sugar - preserved fruit
mưu	scheme; plot; conspiracy
Mỹ	America
mỹ thuật	art
na	to tole; to bring
na ná	akin, alike
nạc	lean meat
nách	armpit
nai	deer
nài	to mind
nài xin	plead
nam	male
năm	5, year
nấm	mushroom
nắm	grip, squeeze
nằm	lay
nắm bắt	seize, grasp
nam châm	magnet
nắm chặt	grip
Nam cực	antarctic
nắm đấm	fist
nam diễn viên	actor
năm mươi	fifty
nằm sóng soài	lying flat motionless
nắm tay	fist
nam tuwocs	baronial
nan	difficult
nắn	to mould; to model; to set
nạn	danger; calamity; disaster
nạn 	crisis
nạn đói	famine
nạn nhân	victim
nắn nót 	tedious care
nang	(anat) follicle; follicule
nàng	she; her 
nâng	to raise
năng	frequently, often, many a time
nắng	sunshine
nặng	heavy
nâng 	elevate
năng 	frequent, often
nắng ấm	sun-kissed
nâng cao	raise
năng động	active
nâng lên	elevate
nâng lên 	raise to
nặng nề	burdensome
năng suất	capacity, yield
nanh	fang, canine
nào	which, uncertain 
não	brain
nạo	to scrape; to clean; to clean out
náo loạn	chaos
nào?	which?
nắp	lid
nát	crushed
nát 	crushed
nâu	brown
nấu	cooking
nấu ăn	cook, cuisine
nấu chậm	brewing
nâu đốm	brindle
nấu sôi	simmer
nay	now; at present; at this time
này	this
nãy	just ago
nấy	that [person]; that [thing]
nầy	this (same as: này)
nảy	bouncing
nay 	this
này đây	hey this
né	dodge
nê	flimsy pretext
nề	smooth (mortar)
nẻ	cracked; chapped; choppy
nể	to respect;to have sonsideration for
né tránh	dodge
ném	pitch, throw, cast, toss
nén	compress
nên	should
nến	candle
nền	background
nến 	candle
nền 	background, floor
nền kinh tế	economy
nền tảng	basis
nền văn minh	civilization
nẻo	way; direction
nép	to crouch
nếp	fold, crease
nếp nhăn	wrinkle, crease
nét	stroke; line (of pen); line
nết	habit, behaviour
nét 	stroke
nết na 	proper and sweet
nếu	if
nêu 	stated
nếu không	otherwise
ngã	to fall; to tumble down
ngả	way; direction
ngã 	fall
ngả 	lean
ngã bất thình lình	tumble
ngắc	get stuck, get held up
ngài	bombycid moth
ngâm	soak
ngăm	tawny complexion
ngầm	secret, underground ; tacit
ngắm	to contemplate;to look at admire oneself
ngăm 	dark complexion
ngấm 	slowly feeling the effect, water soaking effect
ngầm 	underground, hidden
ngắm 	watch
ngấm ngầm 	implicit, hidden
ngàn	thousand
ngăn	compartment
ngắn	short
ngẩn 	silly, dumbfound
ngăn cản	discourage
ngăn chặn	halt, prevent, deter
ngắn gọn	brief, concise
ngân hàng	bank
ngắn hơn	shorter
ngăn kéo	drawer
ngần ngại	hesitate
ngạn ngữ	adage, proverb
ngân sách	budget
ngang	horizontal
ngẩng	lift, raise (neck, head, face); (look up: ngửng)
ngẩng 	lift/raised look
ngang ngạnh	defiant
ngang qua	across
ngạnh	barb
ngành công nghiệp	industry
ngành hàng không vũ trụ	aerospace
ngạo	to scoff; to laugh at
ngáp	yawn
ngập	flooded; submerged; inundated
ngáp 	yawn
ngập 	flooding, overflow
ngất	faint, swoon, become onconscious
ngắt	disruption
ngặt	strict, stringent, rigorous
ngấu nghiến	devour
ngẫu nhiên	random
ngay	direct; straight
ngáy	snore
ngày	day 
ngay bây giờ	right now
ngay cả	even
ngày chủ nhật	Sunday
ngày hội	carnival
ngay lại 	right back
ngay lập tức	right away, immediate
ngày mai	tomorrow
ngày nay	nowadays
ngay ngắn	neatly
ngây ngất	ecstasy, euphoria, seventh heaven
ngay sát	adjacent
ngày sinh nhật	birthday
ngay thẳng	straight
ngày tháng	date
ngây thơ	naive, innocent
ngày trong tuần	weekday
nghe	listen, hear
nghề	work; craft; occupation; profession; business; trade
nghệ	(bot) saffron; croeus
nghe lỏm	eavesdrop
nghề nghiệp	occupation
nghe rõ	audible
nghệ sĩ	artist
nghề thủ công	craft
nghệ thuật	artistic, art
nghệ thuật cắt dán	collage
nghe trộm	eavesdrop, bugging
nghênh	look round, look about one
nghèo	poor
nghèo đói	poverty
nghèo hơn	poorer
nghẹt thở	choke
nghi	to doubt; to suspect
nghĩ	thought, think
nghỉ	to rest; to repose; to take a rest
nghỉ 	rest
nghỉ giải lao	recess
nghi ngờ	doubt
nghĩ ngợi	think, ponder, lost in thought
nghỉ ngơi 	rest
nghĩ ra	devise
nghi thức	ceremonial
nghĩa	dense; meaning; impont
nghĩa 	means; a bond
nghĩa là	means
nghĩa trang	cemetery
nghĩa vụ	obligation
nghịch	contrary; opposite; reverse
nghịch lý	paradox
nghịch từ	diamagnetic
nghiêm	strict; grave; stern
nghiêm 	serious, strict
nghiệm 	mentally verify base on experience
nghiêm khắc	stern
nghiêm ngặt	rigorous
nghiêm trọng	serious, grave, severe
nghiến	grinding
nghiện	addict
nghiền 	crushed
nghiên cứu	research
nghiên cứu sâu	delve
nghiện rượu	alcoholism
nghiêng	tilt
nghiêng về	prone
nghiệp	fate
nghiệt	too severe, too strict
nghiệt ngã	grim
nghìn	thousand
nghịt	dense, deep
ngìn	thousand
ngo	dainty
ngó	to see; to look at
ngô	corn
ngõ	gate; alley
ngơ	ignore, overlook, let pass, connive
ngọ	midday, zodiac year of the horse
ngờ	to suspect; to doubt
ngỡ	to think; to believe, thought to be…
ngộ	queer, unique
ngó 	look
ngớ 	stupid(fy)
ngớ ngẩn	silly
ngớ ngẩn 	silly, nonsense
ngố nghịch	insubordination
ngoa	sharp-tongue
ngoa 	exaggerate
ngoài	besides, beyond
ngoại	foreign
ngoại giao	diplomatic
ngoại lệ	exception
Ngoài ra	addition
ngoại tình	adultery
ngoài trời	outdoor
ngoại trừ	without, except
ngoan	good; well-behaved
ngoan 	good, obedient
ngoảnh	turn one's head, turn round
ngọc	pearl; gem; precious stone
ngốc nghếch	silly
ngọc trai	pearl
ngoe nguẩy 	wagging
ngói	tile
ngòi	canal; arroyo, primer; fuse; match
ngôi	throne
ngồi	sit
ngơi	knock off
ngồi 	sit
ngợi 	praise
ngôi mộ	tomb
ngôi sao	star
ngôi vua	throne
ngon	savory, delectable, delicious
ngón	finger, toe
ngôn	language, speak (nói)
ngốn	gobble, cram, bolt
ngọn	top
ngốn 	hog, gobble mouthful
ngọn 	tops, peak
ngón áp út	ring finger
ngón chân	toe
ngón giữa	middle finger
ngọn hải đăng	light house
ngọn lửa	fire, flame, blaze
ngon miệng	delicious
ngọn nến	candle
ngôn ngữ	language
ngọn núi	alp
ngôn sứ	prophet, messenger
ngón tay	finger
ngón tay cái	thumb
ngón tay trỏ	index finger
ngón tay út	little pinky finger
ngỗng	goose
ngọt	sweet
ngớt	abate, subside, cease
ngu	stupid; foolish; doltish
ngủ	sleep
ngụ	to live; to dwell
ngữ	measure, limit, moderation
ngự	be seated in a stately way
ngu đần	dull
ngư dân	fisherman
ngủ đông	dormant
ngủ gà ngủ gật	doze
ngữ pháp	grammar
ngu si	dense
ngủ trưa	nap
ngứa	itch
ngửa	with face upward, on one's back
ngựa	horse
ngựa con	colt
ngựa vằn	zebra
nguẩy 	wagging
ngục	prison; jail; gaol
ngực	bust, chest
nguệch ngoạc	scribble
ngửi	sniff
ngửi 	smell
ngưng	stop
ngừng	desist, stop
ngừng lại	stop, halt
ngược	upside down
ngược 	back, against the flow
ngược dòng	upstream
ngược lại	reverse, on the other hand
nguội	cool
ngươi	thou, thee
người	person, people (unique classifier for people)
người ăn	eater
người ăn trộm	burglar
người bạn	amigo
người bạn đường	companion
người bán hàng	vender
người bán thịt	butcher
người bản xứ	aborigine
người báng bố	desecrater
người bảo trợ	patron
người bảo vệ	guard
người bắt cóc	kidnapper
người bị kiện	defendant
người bị thương	casualty
người bị trục xuất	deportee
người cá	mermaid
người cai trị	ruler
người cha	father
người chậm chạp	slouch
người chăn cừu	shepherd
người chơi	player
người chuyên quyền	autocrat
người con	the child
người con trai	son
người đã chết	decedent
người đàn bà	the woman
người đàn ông	the man
người đi bộ	pedestrian
người đi kèm	chaperon
người điên	maniac
người đưa thư	mailman, courier
người đưa tin	messenger
người giúp đỡ	helper
người giúp việc	maid, assistant
người gửi tiền	depositor
người Hàn Quốc	Korean
người hầu	servants, butler
người hiến	donor
người khác	other people
người lạ	stranger
người lái xe chó	dog-driver
người làm việc thiện	benefactor, philanthropist
người làm vườn	gardener
người lãnh đạo	leader
người lớn	adult
người mắc bệnh 	person who is sick (with)
người mắc chứng	person who has symtoms of
người mới đến	newcomer
người nắn bóp	chiropractor
người nhận	addressee
người nội trợ	housewife
người ở	housemaids
người phối ngẫu	spouse
người phụ giúp	helper
người phục vụ	attendant
người phục vụ quầy rượu	bartender
người quản gia	housekeeper
người quen	acquaintance
người quyền cao	dignitary
người ta	people
người thắng cuộc	winner
người thuê nhà	tenant
người trong họ 	people in the family line
người xem	onlooker, spectator
người yêu	lover
người yêu nước	patriot
người 	man; person; people; individual
nguồn	source
nguồn gốc	origin
ngưỡng	threshold
ngượng 	embarrassed
ngưỡng mộ	admire, adore
ngút	rise high, curl upwards
nguy	danger; calamity; disaster
nguy cơ	risk
nguy hiểm	dangerous, peril
ngụy trang	camouflage
nguyên	crude
nguyên 	original, the entire (thing)
nguyên âm	vowel
nguyên chất	raw
nguyên nhân	cause
nguyền rủa	curse
nguyên tắc	principle
nguyên thủy	primitive, ancient
nguyên tử	atomic
nguyên tử nhận ê lếch tron	acceptor
nha	service; bureau
nhá	chew carefully
nhà	house, home; a specialized person (classifier)
nhã	courteous
nhà bếp	kitchen
nhà chứa	brothel, storage
nhà để xe	garage
nhà hàng	restaurant
nhà hát	theater
nhà hiền triết	sage
nhà hóa học	chemist
nhà hỏa táng	crematory
nhà kho	shed, storage
nha khoa	dental
nhà kính	conservatory
nhà lãnh đạo	leader
nhà lập pháp	lawmaker
nhà máy	factory
nhà máy bia	brewery
nhà máy đồ hộp	cannery
nhà máy rượu	distillery
nhà máy sản xuất rượu	winery
nhà nghỉ	lodge, motel
nhà ngoại giao	diplomat
nhà phân phối	distributor
nhà phát minh	inventor
nhà phê bình	critic
nhà sàn	cottage
nha sĩ	dentist
nhà thầu	contractor
nhà thơ	poet
nhà thờ	church
nhà thờ lớn	cathedral
nhà thờ nhỏ	chapel
nhà thực vật học	botanist
nhà thương	hospital
nhà thương điên	mental hospital
nhà tôi 	my house
nhà trẻ	nursery (children)
nhà tù	prison
nhà văn	writer
nhà vệ sinh	restroom, toilet
nhà vô địch	champion
nhác	see all of a sudden
nhấc	lift
nhắc	to lift; to raise; to displace
nhạc	music
nhấc 	lift
nhạc cụ 	musical instrument
nhạc khí hơi	wind instrument
nhắc nhở	to remind, to prompt
nhạc sĩ	musician
nhai	chew
nhái	frog
nhấm	gnaw at
nhầm	wrong
nhắm	to aim at; to train
nhảm	unfounded
nhẩm	revise silently, try to memorize
nhàm 	boring
nhầm lẫn	confuse, mixed up
nhâm nhi	sip
nhằm vào	toward
nhàn	leisure, idle, free
nhân	multiply
nhăn	crumpled; wrinkled; creasy; furrowed
nhằn	eat with one's fron teeth
nhẫn	ring
nhận	receive, realize
nhân 	people, base on (occasion), the inside filling (food)
nhăn 	wrinkle
nhân bản vô tính	clone
nhân cách	manhood
nhân chủng học	anthropology
nhân công	man power
nhận dạng	identification
nhân đây	by the way
nhân đôi	duplicate
nhận được	get
nhân lực	manpower
nhấn mạnh	emphasis, accentuate
nhăn mặt	wince
nhăn nheo	weazened
nhăn nheo 	wrinkle up
nhân nhượng	compromise, make concession
nhận ra	recognize, realize
nhàn rỗi	idle
nhân sâm	ginseng
nhân sự	human resource
nhân tạo	artificial
nhận thức	aware, realize
nhân tố	factor
nhân từ	merciful, of kindness
nhân vật	character
nhân viên 	staff members, employee
nhân viên bảo vệ	watchman
nhận xét	remark
nhăng	nonsensical
nhãng	forget
nhanh	fast, quick
nhánh	branch; limb; bough
nhanh chóng	express, speedy, rapid, swift
nhanh nhẩu	promptly
nhanh nhẹn 	agile, swift
nhánh sông	creek
nhao	be in a stir, get uproarious
nhạo	to laugh at;to mock; to jeer at
nhạo 	tease
nhạo báng 	ridicule
nhào lộn	acrobatic
nhấp	to sip(water); to fake a move
nhập 	Import, to receive (into storage)
nhập cảnh	entry
nhập khẩu	import
nhát	"
shy; timid; faint"
nhất	most, top, first
nhắt	very small, tiny
nhạt	pale in color
nhặt	pick up
Nhật Bản	Japan, japanese
nhất định	certain
nhát gan	coward
nhật ký	diary
nhất quán	consistent
nhất trí	unison
nhau	each other 
nhàu 	creased
nháy	to blink; to wink
nhảy	jump, dance
nháy 	blink
nhạy 	sensitive, quick reflex
nhạy bén	sharp, quick
nhạy cảm	sensitive
nhảy qua	leap
nhảy vọt	a spring, jump
nhảy vụt ra	bounce
nhé	okay?
nhẹ	slight, mild, light weight
nhẹ nhàng	gentle
nhẹ nhàng hơn	gentler
nhẹ nhõm 	relief, weight of shoulder
nhện	spider
nheo 	wink
nhét	to stuff
nhì	second
nhỉ	inn't it, doesn't it…
nhị	two
nhị nguyên	dyadic
nhị phân	binary
nhích 	to move a bit
nhiễm	catch, contract, acquire
nhiệm vụ	mission, task, duty
nhiên liệu	fuel
nhiệt	heat
nhiệt độ	temperature
nhiệt huyết	zeal
nhiệt kế	thermometer
nhiêu	exemption from corvees
nhiều	many, more, numerous, plenty
nhiều hơn	more
nhiều lông	hairy
nhiều lông lá	furry
nhiều nước	watery
nhìn	look
nhịn	endure
nhìn hé	peep
nhìn thấy	spot and see
nhịp	rhythm; cadence; measure; time
nhịp 	rhythm
nhịp đập	pulse
nhịp điệu	musical beat and rythm
nhịp khoan thai	adagio
nho	grape
nhố	pluck
nhỏ	diminutive, minor, small
nhơ	dirty; filthy
nhọ	soot
nhớ	remember
nhờ	to commision
nhỏ dãi	slaver
nhố đi	spit
nhỏ gọn	compact
nho khô	raisin
nhớ lại	recollect, recall
nhổ lông	pluck
nhớ nhà	homesick
nho phủ	vine-clad
nhòa	fade, blur
nhoáng 	shiny, flashy
nhọc	tire, tiring
nhoi	emerge
nhóm	group
nhọn	sharp; pointed; acute
nhờn	greasy
nhọn 	sharp
nhón gót chân	tiptoe
nhớp	slimy
nhốt	cloister
nhốt 	lock, imprison
nhợt nhạt	pale
nhu	flexible, pliant
như	as
nhừ	be well-cooked, be well-done
như 	as
như bụi/bột	powdery
nhu cầu	demand, need
như chì	leaden
như chó sói	wolflike, wolfish
như có sợi	stringy
như con thoi	as a needle
như máy	machine-like
như mèo	catlike
như nhau	similar, equal, same
như sư tử	lionlike
như thế	as/like such
như trẻ con	childish
như trên	as above
như vậy	as/like such
nhục	to be disgraced; dishonoured
nhức	to ache; smarting
nhục 	humiliate, lose face
nhức đầu	headache
nhục nhã 	humiliation
nhún vai	shrug
nhúng	dip
nhưng	but, however
những	many, plural(indicator), multiple
những âm thanh	sounds
những anh em	brothers
những ao hồ	lakes
những áo khoác	coats
những bãi cỏ	lawns
những bài hát	songs
những bàn chân	paws, feet
những bản năng	instincts
những bản sao chép	copies
những bàn tay	hands
những bao bì	wrappings
những bên	sides
những bên sườn	flanks
những bờ biển	shores
những bộ da	skins
những bộ phận	parts
những bờ vai	shoulders
những bộ xương	skeletons
những bộ yên cương	harnesses
những bức tường	walls
những bước	steps
những bước chân	footsteps
những cách	ways
những cái	things
những cái áo choàng	robes
những cái cầu	bridges
những cái cây	trees
những cái chuồng	stables, kennels
những cái cố họng	throats
những cái cửa	doors
những cái đó	those
những cái đùi	thighs
những cái đuôi	tails
những cái hàm răng	jaws
những cái hông	hips
những cái lưỡi	tongues
những cái môi	lips
những cái này	these
những cái răng	teeth
những cái ruy băng	ribbons
những cái song chắn	bars
những cái thùng gố	crates
những cái tố	nests
những cái xương	bones
những cái xương sườn	ribs
những cảm xúc	feelings
những cành cây	boughs
những cảnh quan	sights
những cánh tay	arms
những câu lạc bộ	clubs
những câu trả lời	answers
những cây dương	poplars
những cây gậy	the sticks
những chiếc giày	shoes
những chiến sĩ	fighters
những chó Ét-ki-mô	huskies
những chủng tộc	races, ethnicities
những chuông	bells
những cơ bắp	muscles
những con chó	dogs
những cơn đau	pains
những con gái	daughters
những cơn gió tuyết	snowdrifts
những con mắt	eyes
những con ngựa	horses
những con người	humans
những con quỷ	devils
những con sói	wolves
những con thú	beasts
những con trai	boys
những công tác	despatches
những công ty	companies
những cửa số	windows
những cuộc chiến đấu	fights
những cuộc đua	races, competitions
những cuộc sống	lives
những đầu bếp	cooks
những dấu vết	traces
những dây đai	straps
những đêm	nights
những đèn/ánh sáng	lights
những địa ngục	hells
những điều kiện	conditions
những dịp	occasions
những đồ dùng	utensils
những đồ may mặc	garments
những doanh trại	barracks
những đội	teams
những đội chó	dog-teams
những đồng bạn	mates
những đồng cỏ	pastures
những đồng đội	team-mates
những ghềnh, thác của sông	rapids
những giấc mơ	dreams
những giác quan	senses
những giáo viên	teachers
những giày da	moccasins
những giờ	hours
những giường	beds
những gói	packs
những gót chân	heels
những hàng; chèo	rows
những hành vi trốn tránh	shirks
những hơi thở	breaths
những inxơ (Anh)	inches
nhung kẻ	corduroy
những kẻ cướp	marauders
những kẻ hành hạ	tormentors
những kẻ lái xe chó	mushers
những kẻ lang bạt	journeyers
những kẻ man rợ	savages
những kẻ quậy phá	antagonists
những kẻ tấn công	assailants
những kẻ tham chiến	combatants
những kẻ tìm vàng	goldseekers
những khí hậu	climes
những khối	chunks
những khởi đầu	beginnings
những khúc gỗ mới đốn	logs
những khuỷu tay	elbows
những kỷ niệm	memories
những lần	times
những lỗ mũi	nostrils
những lố tai	ears
những lời mời	invitations
những lứa tuối	ages
những lúc giải lao	recesses
những mép, sườn	chops
những miếng	pieces
những miếng gố	woods
những miệng núi lửa	craters
những mô của cơ bắp	tissues
những năm	years
những ngày	days
những ngày chủ nhật	sundays
những ngọn	tops
những ngón chân	toes
những ngọn lửa	flames, fires
những ngón tay	fingers
những ngực	chests
những người	the people
những người bảo vệ	guards
những người cha	fathers
những người con trai	sons
những người giúp đỡ	helpers
những người khác	others
những người lạ	strangers
những người làm vườn	gardeners
những người mới đến	newcomers
những người xem	onlookers
những người/món/vật	ones
những nhiệm vụ	duties
những nhịp, điệu	cadences
những nhu cầu	needs
những nơi	places
những nội dung	contents
những nổi giằn vặt	pangs
những núi lửa	volcanoes
những pao	pounds
những phần thắng thua	odds
những phút	minutes
những quan hệ	relations
những quý	quarters
những răng nanh	fangs
những roi vọt	lashings
những rủi ro	risks
những sai lầm	mistakes
những sinh vật	creatures
những sợi dây thừng	ropes
những sợi gân	tendons
những sự kiện	facts
những sự ngừng lại	stoppages
những sự nóng giận	tempers
những sự than van	wailings
những sự thích thú	delights
những tấm trải	coverings
những tâm trạng	moods
những tảng băng	glaciers
những tay bắt chó	dog-busters
những than	coals
những thần tượng	idols
những thân xác	bodies
những thành phố	cities
những thế hệ	generations
những thế kỷ	centuries
những thợ lặn	divers
những thời đoạn	periods
những thói quen	habits
những thời trang	fashions
những thốn thức	half-sobs
những thủ phạm	culprits
những thủ thuật	tricks
những thước Anh	yards
những thuyền	boats
những tiếng kêu	exclamations
những tiếng ồn	noises
những tĩnh mạch	veins
những tờ báo	newspapers
những tố tiên	forebears, ancestors
những tội nhẹ	misdemeanors
những trái tim	hearts
những trận đánh	battles
những túp lều	tents
những tuyên thệ	oaths
những vết thương	wounds
những vì sao	stars
những viên	pellets
những vòng tròn	circles
những vũ khí	weapons
những vực sâu	deeps
những vườn cây ăn trái	orchards
những xe trượt tuyết-chó	sled-dogs
những xoáy nước	eddies
những ý định	intentions
nhuốc	sullying, discrediting
nhược	tire, get tired, get weary
nhuộm	to dye
nhường	budge
nhượng bộ	concession
nhượng lại	demise
nhút	salad of salted bits of jack fruit…
nhút nhát	shy, timid, cowardice
ních	to cram, to stuff to pack
niềm đam mê	passion
niềm nở	affable
niêm phong	seal
niềm tin	faith, belief
niềm tự hào	pride
niềm vui	joy
niên	years
niên giám	yearbook
nịnh 	to flatter
nịnh nọt 	to flatter
nít	small wine-bottle
níu	to grab at someone to pull
nó	he/him, she/her, it
nô	frolic, gambol
nố	burst
nọ	that, the other (day)
nở	hatch
nợ	owe, debt
no 	full (stomach)
nó 	he
nỗ 	explode
nở hoa	bloom
nó là	it's
nô lệ	slave
nỗ lực	exert effort, attempt
nóc	roof
nọc 	venom
nọc độc	venom
noi	follow
nói	tell, say, speak, talk
nòi	race
nối	conjoin
nồi	pot
nỗi	feeling
nơi	place, location, spot
nội	field
nội 	internal, father's side
nơi an toàn	asylum
nối bật	prominent, outstanding
nội bộ	internal
nỗi buồn	boredom
nội các	cabinet
nỗi đau đớn	anguish
nổi đau khổ	torment
nơi đậu xe	parking lot
nói dối	lie
nội dung	content
nói gì	say what
nói gì?	say what?
nổi giằn vặt	pang
nơi hỗn loạn	pandemonium
nơi làm việc	workspace
nói lè nhè	drawl, slur
nổi loạn	mutiny, rebel
nói lúng búng	bumble
nơi nào	somewhere, which place
nói nhỏ	whisper
nơi ở	residence
nói oang oang	bawl, holler, shout
nơi rửa tội	baptistery
nỗi sợ hãi	phobia, fright
nội tâm	introspective
nối tiếng	famous, celebrity
nối tiếp	continuing
nơi trú ẩn	shelter, refuge
nói với	told
nối xung	rampage
nom	take a good look at, peer at
nôm	prose-like, simple, easy to understand
non	young; mountain
nón	hats
nôn	vomit
nôn 	vomit, full of anxeity
nóng	hot
nông	shallow
nồng	hot; strong; warm, ardent, fervid
nông dân	farmer
nóng giận	temper
nông nghiệp	agriculture
nóng trắng	white-hot
nộp	hand in, pay
nộp hồ sơ	filing
nốt	spot; mark; (bot) cecidium;
nốt ruồi	mole
nữ	female
nụ cười	smile
nữ diễn viên	actress
nữ hoàng	queen
nữ nam tước	baroness
nữ sinh viên	quail
nữ tính	feminine
nữa	half, anymore, too
nửa	half
nửa chừng	halfway
nửa đông lạnh	half-frozen
nửa giống lai	half-breed
núc	tighten, twist tight
nực	hot weather
nức nở	sob emotionally
núi	mountain
núi lửa	volcano
núm vú	nipple
nung	to burn; to fire; to bake
nũng	court fondling from, court pampering from, coddle oneself
nuớc	water
nước	water, country
nước 	water
nước Anh	England
nước bọt	saliva
nước cộng hòa	republic
nước dãi	drool
nước ép	juice
nước mặn	brine, salty liquid
nước mắt	tears
nước ngoài	foreign
nước thủy triều	tide-water
nuôi	feed, take care, adoptive
nuôi lấy	take care (of)
nương	to lean on; to depend on
nướng	broil
nướng bằng lò	bake
nuốt	swallow
nuốt chửng	gulp
núp	to take cover; to take shelter
nút	button
nứt	crack
nứt 	cracked
nút chai	cork
nứt nẻ	cracks
nút thắt	knot
ô	umbrella
ố	den
ồ	oh
ơ	to be indifferent
ở	at, stay
ợ	burb
ố bi	bearing
ở bụng	abdominal
ở đâu	where
ở đâu?	where?
ở đây	here
ố đĩa	drive
ở đó	there
ở dưới	below
ở đuôi tàu	aft
ở giữa	middle, median
ở hậu trường	backstage
ở kề bê	adjoin
ô nhiễm	pollution
ở nước ngoài	abroad
ở thành phố	downtown
ô tô	automobile
ở trần	topless
ở trên giường	abed
ở trên không	airborne
ở truồng	naked below
oai	stateliness; majestry; imposing appenrance
oan	being victim of an injustice
oán	to resent; to feel resentment against
oát	watt
ốc	snail, slug
ốc biển	conch
ốc sên	snail
ôi	tainted (meat); putrid (flesh)
ối	all over; widespread, turn color
ỏi	noisy, uproarious
ơi	ơi is a calling emphasis to the other person 
ới	hey; call repeatedly
ôi 	oh
ôi chao	wow
ôm	hug
ốm	sick
ốm giả vờ	fake sickness
ốm nghén	morning sickness
ôm ốm	hollow
ôn	to review; to revise
ơn	favor
ốn 	settle, steady, calm
ồn 	noisy
ớn 	scary
ồn ào	noisy
ốn định	stable
ớn sợ	eerie, scared
ôn tồn	bland
ong	bee
ông	title address Mr, grandfather, older man level
ống	pipe
ông bà	grandparents
ông chủ	boss
ông cố	great grandfather
ống khói	chimney
ông này	he, this man
ong nghệ	bumblebee
ông ngoại	grandfather (mother'side)
ống nhòm	binocular
ông nội	grandfather (father'side)
ông trùm	baron
ống, cuộn	reel
ớt 	chilli pepper
ôxy	oxygen
pao	pound
pha	mix
phá	smash
phả	reek, breath
phá 	destroy, break a (silence, pattern)
phà 	ferry
pha chế	mixing compound
phá đố	overthrow, destroy
phá hỏng	disrupt, break
phá hủy	destroy, devastate
pha lê	crystal
pha loãng	dilute
phá sản	bankrupt
phá thai	abort, abortion
pha trộn	blend
phá vỡ	break-up
phác	to sketch, to draft
phắc	like a grave
phác thảo	outline
phai	fade
phái	to delegate, to send, to detach
phải	must, correct, right(side)
phải chăng	sane
phái đoàn	delegate
phải là	must be
phái mạnh	stronger sex
phái yếu	weaker sex
phàm	coarse, philistine
phẩm	dye
phạm	to offend, to contravene, to commit
phẩm cách	dignify
phẩm giá	dignity
phạm tội	delinquent
phạm vi	range, scope
phán	say, declare
phân	stools, excrements
phấn	chalk
phần	part, section, portion
phẫn	lid
phận	status, station, rank, place, position
phân 	excrements, divide, distribute
phấn 	chalk, powder make up
phản ánh	reflect
phân biệt	distinguish, differentiate, discriminate
phân biệt được	distinguishable
phân bố	allocate
phản bội	betray, treachery
phân bón	fertilizer
phấn chấn	catharsis
phân chia	division
phản chiếu	reflecting
phần còn lại	the rest, remainder
phân công	assign
phấn đấu	strove
phán đoán	judgement, problem solving
phản đối	oppose, disapprove, disagree, protest
phấn hoa	pollen
phân hủy	decompose
phân hủy được	decomposable
phấn khích	excited
phấn khích 	excited, embolden
phân khúc	segment
phân loại	segregate, sort, classify
phân ly	torn away (unwanted goodbye) 
phàn nàn	complain
phẫn nộ	outrage
phân nửa	half
phân phối	distribute
phản quốc	treason
phân số	fraction
phân tán	scatter, disperse
phân tán được	dispersible
phần thắng thua	odd
phân tích	analyze
phần trăm	percent
phân trộn	compost
phản ứng	react
phản ứng mạnh	backlash
phân vân	wonder
phân vị	percentile
phán xét	judges
phân xử	settle an issue
phang	to throw stick at
phăng	immediate, instant
phẳng	flat
phao	float
phào 	sigh
pháp 	French, principle of (rule)
pháp luật	law
pháp lý	legal
phập phồng	anxious, nervous, unsettled
Pháp-Canada	french-canadian
pháp-canada 	French-Canadian
phát	distribute, boom
phạt	punish
phật	buddha
phạt 	fine, punish
phát âm	pronounce
phát ban	rash
phát đạt	prosper
phát hành	release
phát hiện	detect
phát huy	uphold
phát minh	invention
phát nố	explode
phát sáng	glow
phát sóng	transmit wavelength
phát thanh	broadcast
phát thuốc	dispensary
phát triển	develop, grow
phê bình	criticize
phê duyệt	approve
phế liệu	scrap
phế quản	bronchial
phép	magic power
phép điện nhiệt	diathermy
phép lạ	miracle
phi	(of horse) to gallop, to eject
phí	charge
phì	blow, send out, let out, puff out
phỉ	bandit
phí bảo hiểm	premium
phi công	pilot
phí cộng thêm	surcharged
phi hành đoàn	crew
phi hành gia	astronaut
phi lợi nhuận	nonprofit
phi luân lý	amoral
phía	side, way, direction
phía bắc	north
phía bên kia	the other side
phía đông	eastward
phía nam 	south side/direction
phía sau	rear
phía tây	western
phía tây bắc	northwest
phía trước	in front, forward
phiền	to annoy, to bother, to disturb
phiện	opium
phiến gỗ	plank
phiền muộn	dismal, depression
phiền phức	worrisome
phiến quân	rebels
phiến sừng ở hàm (cá voi)	baleen
phiên tòa công khai	public hearing
phiêu bạt	wandering 
phiêu lưu	adventure
phim	movie
phim hoạt hình	cartoon
phim tài liệu	documentary
pho	set; unit
phó	deputy
phò	 to escort, to assist
phố	street, house, apartment
phơ	snowy
phố biến	popular
phó giám đốc	vice president
phối	lung
phơi	to dry in the sun
phối hợp	coordinate
phong	confer
phóng	zoom, dash
phòng	room, chamber, department
phỏng	burnt
phóng 	to jump toward, throw
phong bì	envelope
phong cách	manner
phòng cấp cứu	emergency room
phông chữ	font
phóng đại	exaggerate
phóng đảng	wild behavior
phỏng đoán	conjecture
phong hóa	petrify
phòng khiêu vũ	ballroom
phóng khoáng	open-minded
phòng ngủ	bedroom
phong phú	ample
phóng ra	ejaculate
phòng tắm	bathroom
phòng thí nghiệm	laboratory
phòng thủ	defend
phòng thử quần áo	fitting room
phóng to	magnify
phong trào	movement
phòng triển lãm	exhibit room, gallery
phòng tù	cell
phóng viên	reporter, correspondent
phong vũ biểu	barometer
phóng xạ	radioactive
phớt lờ	ignore
phu	coolie
phù	swell like or be puffed (with oedema)
phủ	to cover; to overlay
phụ	auxiliary
phụ âm	consonant
phù dâu	bridesmaid
phụ giúp	help
phù hợp	fit, appropriate for
phù hợp với	fit, appropriate for
phụ lục	addendum, appendix
phủ nhận	negate
phụ nữ	woman, female
phù phiếm	vain, superficial
phù thuộc	dependent
phụ thuộc	depend
phù thủy	witch
phụ trách	in charge, responsible
phụ tùng	accessory
phúc	happiness; good fortune
phục	to admire ; to esteem
phục 	admire, accept the superiority of 
phục hồi	recover
phục kích	ambush
phúc lợi	welfare
phục lục	addendum
phức tạp	complex
phục vụ	serve, service
phủi	flick off
phun	spray, spit
phụng	phoenix
phương	way; direction
phường	ward
phương bắc	northern
phượng hoàng	phoenix
phường hội	fraternity
phương pháp	method
phương pháp tiếp cận	approach
phút	minute
phút 	minute
phụt 	spray in a stream
pin	battery
qua	passing, by, pass, past
quá	too
quả	the (for fruits, round objects)
quạ	crows
quá 	too, exceed
quả bóng	ball
quả chuối	banana
quả đào	peach
qua đêm	overnight
quá khứ	past
quả lê	pear
qua miệng	by verbal
quả mơ	apricot
quá mức	excessive
quá nóng	overheat
quả quyết	affirmative
quả quýt	tangerine
quả rụng	windfall
quả sơ ri	cherry
quả tạ	dumbbell
quà tặng	gift
quả tang	red-handed
quá trình	process
quả trứng	egg
quách	expression: "just get it over with"
quái 	freak, monster
quái vật	monster
quắm	curved; hooked
quan	commando
quán	inn; restaurant; store; house
quân	army
quăn	curly
quần	pants, trouser
quằn	to bend; to curve
quản	canal
quẩn	be muddle-headed
quần áo	apparel, attire, clothes
quan điểm	perspective
quân đội	military, army
quản gia	caretaker
quan hệ	communion, relation
quan hệ thân thuộc	affiliate
quan hệ thân tộc	kindred
quan hệ tình dục	sex
quản lý	manage, management
quần ngắn	short
quân nối dậy	rebel
quán rượu	saloon, liquor bar
quân sự	military
quan tài	casket, coffin
quan tâm	mind, concern
quản thúc	house arrest
quẫn trí	distraught, very stress
quan trọng	important, crucial
quan trọng hơn hết	most important
quan trọng nhất	most important
quang	optic
quăng	mosquito larva
quãng	section
quặng	ore
quăng 	toss, throw sideway, hurl
quãng 	distance
quảng cáo	advertise
quanh	around
quánh	to be firm; thick
quát	to shout; to storm
quạt	fan
quất 	to whip
quạt 	fan
quật 	to excavate, whip
quay	turn, crank, spin; to roast
quây	to enclose
quậy	to stir up; to move
quấy 	harass, stir, do wrong
quầy bán thịt	butcher shop
quấy rầy	disturb, annoy
què	crippled; disabled; lame
quê	native place
quế	cinnamon
que 	rod, small stick
quê hương	hometown, home country
quen	familiar; acquainted
quên	forget
quên 	forget
quen biết sơ sơ	acquaintance
quên lời	forget the words
quen thuộc	familiar
quét	sweep(ing)
quết	to knead
quét 	scan, sweep
qui	tortoise
quí	quarter
quí tộc	aristocratic
quít	mandarin; mandarine; tangerine
quịt	bilk
quở	to scold; to reprove
quở 	scold
quốc	nation; state; country
quốc gia	nation, country
quốc hội	congressional
quốc tế	international, of the world, global
quốc tịch	nationality
quy	bring together, converge; recognize; state; convert
quý	quarter
quỳ	sunflower, heliotrope
quỹ	fund
quỷ	devil
quỷ 	devil
quý bà	lady
quỹ đạo	orbit
quy định	regulations, terms
quý giá	precious
quỳ gối	kneel
quy mô	scale, extent
quý ông	gentlemen
quy tắc 	rule, principle
quỹ tài chánh	fund
quý tộc	aristocratic
quy ước	convention
quyên	a swamp-hen; to raise fund
quyến	glosy black silk gauze
quyền	right
quyển	the (for books)
quyền 	right, power
quyền anh	boxing
quyền lực	(social) power
quyền năng	higher power
quyến rũ	charm, allure, bewitch
quyển sách	(the) book
quyền tối cao	supremacy
quyển vở	(the) notebook
quyết	to decide; to determine
quyết 	decide, decisive
quyết định	decide
ra	to go out of, exert (action)
rạ	rice stubble
ra đi ô	radio
rã đông	defrost
ra lệnh	dictate, give order, command
ra ngoài	out
rác	rubbish, garbage
rắc 	sprinkle
rắc rối	trouble
rắc rối 	trouble, problem
rác thải	waste
rách	torn
rạch 	canal, to scratch and cut
rách rưới 	ragged and torn
rải	to spread; to scatter; to lay
rầm	beam
rằm	the fifteenth of the lunar month, the full-moon day
rậm	thick; bushy; dense
rầm rì	murmur
rán	fry
răn	admonish, counsel
rắn	solid
rạn nứt	to crack
rán sức	exert
ràng	to fasten; to bind; to tie up
răng	tooth
rằng	that
rạng	begin to break
ràng 	to tie
răng 	tooth
ràng buộc	bound, bind, obligate
rạng đông	daybreak
răng nanh	fang
rãnh	drain, trench
rảnh	be free; to have leisure
ranh 	mischievious, dividing line
ranh giới	boundary, border
ranh mãnh 	sly, mischievious, street smart
ráo	dry
rào	fence; hedge
rảo	accelerate, quicken (ones pace)
rào cản	barrier
ráo riết	speedily and continuously
rập	to copy closely
rạp 	stage, theater
rạp chiếu phim	cinema
rạp xiếc	circus
rất	very
rất vui được gặp bạn	very nice to meet you
rau	vegetable
râu	beard
rầu	sad; sorrowful
rau diếp	lettuce
rầu rĩ 	upset and gloomy
rày	from now on
rầy	scold
rẩy 	shake (dust or water off)
rẽ	diverge, turn
rễ	root
rẻ	cheap
rê bóng	dribble
rẻ hơn	cheaper
rẻ mạt	crummy
rẻ tiền	cheap
rèm	drape
rèn	forged
rên 	whimper
rên rỉ 	whimper and moan
rệp	bedbug
rệp cây	aphid
rét	to be cold
rết	centipede
rêu	moss
rỉ	to leak; to drip
rỉ 	rust
rì rầm	murmur
rìa 	edge
riêng	especial; peculiar; private; own
riềng	galingale, alpinia (ginger family)
riêng 	private, exclusive
riêng biệt	especially separate, private
riêng đặc biệt	especial
riêng tư	personal, private
riết	pull tight; (to do something) continuously
rình	to watch; to spy
rít lên	shrill
rìu 	ax
rìu nhỏ	hatchet
rõ	clear
rỏ	to drip; to ooze
rõ 	apparent, articulate, clear
rõ ràng	apparent, articulate, clear
rõ rệt	transparent, apparent, clear
rò rỉ	leak
roi	whip; rod cane
rối	tangled; entangled; a puppet
rồi	already
rơi	drop, fall
rời	to break off; to break loose; to leave
roi 	rod, small stick, whipping stick
rối 	puppet, tangle
rồi 	already
rơi 	fall
rời bỏ	desert
roi da	leather whip
roi đánh xe	riding-whip
rối loạn	disturbance
rối tung	tangle
roi vọt	lashing
rơm	straw
rợn	creepy, scared
rộn 	busy and excited
rộn ràng	thrill
rong	alga; seaweed; wandering about
rồng	dragon
rộng	wide, broad
rộng lây lan	wide-spreading
rộng lượng	generous
rộng rãi	commodious, spacious
rỗng tuếch	vain, superficial
rót	pour in
ru	to rock; to sing; to lull 
rú	to scream; to yell; to howl
rủ	entice someone to do things together
rũ 	stretched dropped down motion
rủ 	to entice, drag (someone to do…)
rũ rượi 	weary and exhausted
rùa	tortoise
rủa	to curse; to call down; to curse upon
rửa	wash
rực rỡ	brilliant
rủi ro	risk
run 	quiver
run lên	shiver, tremble
run rẩy	trembling, shiver
rung	shake
rụng	to fall; to drop
rừng	forest
rung 	vibrate, shake
rừng 	forest
rung động	stir, affect
rung lên	vibrate, shaken up
rước	to receive; to greet; to welcome
ruồi	fly
rưỡi	half
ruộng	rice-field; paddy-field
rương	box; trunk
ruột	bowel
rượu	wine
rượu bia	ale
rút	to pull out; to draw out; to get out
rụt	to withdraw; to take back
rút hết	deplete
rút lại	retract
rút lui	retreat
rút ngắn	shrink
sa	fall, drop
sà	to throw oneself
sà lan	barge
sa sút	drab, decadent
sa thải	dismiss
sắc	royal honour-conferring diploma
sắc lệnh	edict, decree
sắc nét	sharp
sắc tố	pigment
sắc xảo	acute
sách	book
sạch	clean
sai	wrong
sài	children's lasting and serious disease
sai khiến	to boss
sai lầm	mistake
săm	inner tube, tube
sầm	to darken, to cloud over
sắm	to go shopping, to shop, to go and buy (get)
sậm	swart
sấm sét	thunder
sàm sỡ	vulgar
sàn	floor
sân	field (unique classifier for open space nouns)
săn	hunt
sẵn	ready, available
sân bay	airfield, airport
san hô	coral
sân khấu	stage
sản phẩm chưng cất	distillate
sẵn sàng	ready
sân trong	courtyard
sản xuất	manufacture, produce
sáng	bright, light
sàng	sieve, screen
sang 	to cross over to, luxury status
sáng chói	ablaze
sáng lập	founding
sang một bên	aside
sáng trăng	moonlight
sang trọng	luxurious
sành	be conversant with, be a connoisseur in
sao	why
sào	perch, rod
sao 	how; star
sao chép	plagiarism
sao cho mau 	so quickly
sao chối	comet
sao?	why?
sáp	wax
sắp	to pile, to arrange, to set
sập 	collapse
sắp đặt	arrange
sắp xảy ra	impending
sắp xếp	sort, arrange
sát	ajacent, next to, killing(adjective)
sắt	iron (metal)
sạt	take off part of
sắt đá	extremely firm as iron and stone
sau	behind, later, after
sáu	six
sâu	a worm; deep, profound
sáu 	six
sau chiến tranh	post war
sau cùng	ultimately, in the end, finally
sau đây là	after this is
sau đó	then
sau đuôi	rear
sâu hơn	deeper
sau khi	thereafter
sáu mươi	sixty
sáu mươi dặm	sixty-mile
sau này	afterward
sâu xa	remote
sau, ở đằng sau	hind
sầy	scratched
say 	drunk
say rượu	drunken
say sưa	booze
sẽ	will, shall
sẻ	to divide, to share
sen	lotus
sên	snail
seo	arched quill-feather (of a cock)
si	si (silicon)
sì	very, excessively, extremely
sĩ	feudal scholar, feudal intellectual, feudal intelligentsia
sỉ	by wholesale
sỉ nhục	dishonor
sĩ quan chỉ huy	commandant
siêng	diligent
siêng năng	diligent
siêu việt	masterful
sinh	born, give birth
sình	mud; marshy, muddy
sinh đẻ	natal
sinh động	animate, vivid
sinh hạ	birth, labor
sinh học	biology
sinh ra	born, give birth (out to)
sinh sản	reproduce
sinh thiết	biopsy
sinh vật	creature
sò	oyster
số	number
sơ	cursory
sớ	petition to the king
sờ	to touch, to feel
sở	service
sợ	fear, afraid
sờ 	touch
sở 	facility
sơ cứu	first aid
số điện thoại	telephone number
sơ đồ	diagram
sợ hãi	fear
sợ hãi 	fearful
số học	arithmetic
sở hữu	possess
số không	zero
số lượng	amount, quantity
số lượng lớn	bulk, large quantity
số năm	number five, 5
số nhiều	plural
số phận	destiny, fate
so sánh	compare
sơ tán	evacuate
sổ tay	writing pad
sở thích	hobby
số tiền thâm hụt	deficit, money loss
soạn	to prepare; to compose; to compile
soạn 	compose, organize
sóc	squirrel
sốc	shock
sóc chuột	chipmunk
soi	to luminate
sói	wolf
sôi	boiling; to rumble
sỏi	gravel
sợi	fiber
sôi 	boiling
sợi cứng	bristle
sợi dây	cord
sợi dây thừng	ropes
sợi gân	tendon
sói khóc	wolf-cry
sôi nối	dynamic and exciting
sỏi thận	calculus
sớm	early, soon, premature
sớm hơn	sooner
sơn	paint
sờn	to rush at, to rush headlong at
sởn gai ốc	creepy
sóng	wave
sông	river
sống	live, alive
song 	bar (window, cage), yet
sóng 	wave
sòng bài	casino
sông băng	glacier
song ca	duet
sống dưới nước	aquatic
song ngữ	bilingual
song song	parallel
sông suối nhỏ	creek
sống tách biệt	seclude
sống thuyền	keel
sốt	fever
sọt	crate
sót 	remain, left over
sốt 	fever
sốt cao	high fever
sốt nhẹ	mild fever
sư	uddhist priest, bonze
sứ	by wholesale
sử	to hasy down
sự	noun for a condition, action, state of mind
sư 	monk, teacher
sự an toàn	safety
sự an ủi	consolation
sự ảnh hưởng	the effect
sự bảo vệ	protection
sự bất lực	helplessness
sự biến hình	the transformation
sự biểu hiện	expression
sự bồng bột	vulnerability
sự bóp méo	distortion
sự buộc tội	accusation
sự ca ngợi	acclaim
sự cải nhau	spat
sự cay đắng	bitterness
sự chấp nhận	acceptance
sự cố	incident, unexpected problem
sự cố gắng	attempt, trying effort
sự co thắt	spasm
sự cố ý	deliberateness
sự dại dột	rashness
sự đau buồn	grief
sự đau đớn	aching, pain
sự đau khổ	woe
sự đau nhức	ache
sự điên rồ	madness
sự diệt vong	apocalypse
sự điều khiển	control
sự điều trị	treatment
sự đọa đày	damnation
sự đoàn kết	solidarity
sự đối lập	antagonism
sự đối xử	treatment
sự dồn lại, tích lại	accrual
sự dữ dằn	fierceness
sự dự toán	estimation
sử dụng	use
sự e sợ	apprehension
sự gãy	fracture
sự ghi âm	audio
sứ giả	messenger
sự gia hạn	extention
sứ giả, người đưa tin	messenger
sự giận dữ	fury
sự giành được	acquisition
sự giàu có	wealth
sự giựt lùi	resiliency
sự há hốc miệng	gape
sự hạ xuống, gốc	descent
sự hài hòa	harmony
sự hài lòng	satisfaction
sự hạn chế	abridgment
sự hân hoan, thích thú	delight
sự hành động	action
sự háo hức	eagerness
sự hiện hình	wraith
sự hỗ trợ	backup
sự hòa tan	diluent
sự hóa thân	incarnation
sự hoan hô	ovation
sự hoanh nghênh, hoan hô nhiệt liệt	acclamation
sự hoạt hóa	activation
sự hướng dẫn	instruction
sự hút bám	adsorption
sự huyền bí	mystery
sự huyên náo	ruction
sự im lặng	silence
sự kén chọn	fastidiousness
sự khạc nhố	spit
sự khiển trách; làm cho không thấm nước lại	reproof
sự không bình thường	anomaly
sự không suy nghi	indiscretion
sự khủng bố	terror
sự khuyến khích	encouragement
sự kiểm kê	census
sự kiện	event, fact
sự kinh dị	horror
sự kinh hoàng, sự kinh ngạc	consternation
sự kinh ngạc	astonishment
sự kinh tởm	disgust
sự lạ lùng	peculiarity
sự lẩm bẩm	mutter
sự làm bực mình, sự làm phật ý	vexation
sự lãng trí	forgetfulness
sự lãnh đạo	leadership
sự lanh lẹ	alertness
sự lau	scour
sự liên lạc	touch
sự lôi cuốn	affinity
sự lớn dần lên	accretion
sự lựa chọn	choice
sự mập mờ	ambiguity
sự mất tinh thần	dismay
sự mau chóng	celerity
sự mờ	blur
sự mở rộng	extension
sự ngắn gọn	concision
sự ngây ngất	ecstasy
sự nghiệp	career
sự ngoại lệ	exception
sự ngừng lại	stoppage
sự nhầm lẫn	confusion
sự nhạy bén, sự nhảy cảm	acumen
sự nóng giận	temper
sự ồn ào	din
sự phá sản	bankruptcy
sự phản bội	treachery
sự phấn khích	excitement
sự phẫn nộ	outrage
sự phát triển	development
sự phòng thủ	defence
sự phụ thuộc	associate
sự quản lý	administration
sự quen thuộc	familiarity
sự quyến rũ	charm
sự rạn nứt	breakdown
sự rán sức	exertion
sự rộn ràng; rung động	thrill
sự sắc xảo	acuteness
sự sắp đặt	backdrop
sự sắp xếp	arrangement
sự sơ cứu	first aid
sự sở hữu	possession
sự suy thoái văn minh	decivilization
sự tàn ác	cruelty
sự tán thưởng	applause
sự tán thưởng và công nhận thành quả	accolade
sự táo bạo	audacity
sự teo	atrophy
sự tha tội, sự tha bống	acquittal
sự thách chiến	defiance
sự tham vọng	ambition
sứ thần Chúa	angel of the Lord
sự thận trọng	caution
sự than van	wailing
sự thật	truth
sự thích nghi	adaptation
sự thích thú	delight
sự thiếu	deficient
sự thờ ơ	apathy
sự thoái hóa	retrogression
sự thông tin, bộ phận chuyển kéo	conveyance
sự thụ động	passiveness
sự thử giọng	audition
sự thường xuyên	regularity
sự tiến động	precession
sự tiết lộ; mặc khải	revelation
sự tỏa rộng	the wide spread
sự tồn tại	existence
sự trả thù	venegeance
sự trượt, lướt	glide
sư tử	lion
sư tử 	lion
sự tức giận	anger
sự tương phản	contrast
sự tương tự	analogue
sự tưởng tượng	imagination
sự tương xứng, sự thích đáng	adequacy
sự tuyệt vọng	desperation
sự vâng lời	obedience
sự vay mượng	loan
sự vĩ đại	greatness
sự việc	the event
sự vui vẻ	zest
sự xem xét	consideration
sự xuất hiện, bề ngoài	appearance
sự xuất khẩu	export
sự xúc tác	catalysis
sự xung đột	strife
sủa	to bark
sữa	milk
sửa	to repair
sủa 	bark
sửa 	to correct
sửa chữa	repair, fix, mend
sửa đối	amend
sửa sang	mend
suất xắc	outstanding, remarkable
súc	log
sức	strength, power, force
sức khỏe	health
sức mạnh	strength
sức mạnh, oai phong	prowess
sức nóng	heat
sức quyến rũ	allure
súc sắc	dice
sức sống; quan trọng	vital
sùi 	to foam
sum họp	union, togetherness 
sụn	cartilage
sung	fig, cluster fig
súng	gun
sưng	swelling
sừng	horn
sưng 	to swell
sừng (hươu, nai)	antler
sùng bái	deify
súng đại bác	cannon
sùng đạo	devout
sung huyết	congestive
sửng sốt	daze
sung sướng	happy
súng trường	rifle
sung túc	affluence
suối	a water spring
sườn	side of man's chest, side, flank
sườn 	rib, sloping side of
sướng	happy, elated, pleasureable
sương giá	frost
sương mù	mist, fog
suông sẻ 	smooth
suốt	perpetual, thoughout, through all (time)
suốt đời 	lifetime
sụp đố	collapse
sụt sùi	sobbed sound
sưu tầm	collect
suy	to decline
suy giảm	decline
suy ngẫm	ponder, reflect
suy nghĩ	think
suy ra	arrive at (conclusion)
suy thoái	degrade backward, retrogress
sỹ quan hải quân	admiral
ta	i, me, my (superior(literary) level)
tá	dozen
tả	cholera
tạ	barbell
ta 	we
ta học tập 	we study
tấc	one tenth metre
tắc	to click (one's tongue)
tạc	carve
tác động	impact
tác dụng	effective
tác dụng phụ	side effect
tác giả	author
tác hại	harm
tắc kè hoa	chameleon
tắc nghẽn	congestion
tác phẩm	(art) work
tách	cup
tách rời	separate
tai	ear
tái	pale in color; semi-cooked
tài	talent, gift
tải	load
tại	at, in
tai 	ear
tái 	repeat (action), rare (meat)
tại 	at (location), because of
tái bút	postscript
tài chính	finance
tái cơ cấu	reconstruct
tái diễn	recur
tài giỏi	consummate
tai họa 	disaster
tài khoản	account
tài liệu	document
tai nạn	crash, accident
tài năng	talent
tại ngoại	bail
tái nhợt	cadaverous
tài sản	fortune, property, asset
tại sao	why
tại sao 	why
tài trợ	donate
tai ương	catastrophe
tại vì	because
tài xế	driver
tam	three
tám	eight
tâm	center; man's good heart; mind
tăm	bubble; trace; toothpick
tấm	sheet, classifier for sheet-like objects
tầm	range
tắm	bath
tằm	silkworm
tẩm	to soak
tạm	temporary
tâm 	center, heart, mind
tấm 	plate, unique classifier for platelike item
tầm 	range
tạm biệt	good bye
tấm che	the cover
tạm dừng	pause
tâm hồn	soul
tạm nghỉ	stop temporarily
tầm nhìn	sight range
tâm thần	mental state (ill)
tạm thời	temporary
tâm trạng	mood
tan	to dissolve, to melt, to thaw
tàn	processional parasol
tân	new
tấn	tons; standing position (in kung fu)
tận	ending, finished
tan 	dissolve
tấn 	ton
tản 	dissipation, scatter
tàn ác	cruel
tàn bạo	brutal
tân binh	rookie
tan chảy	melt
tấn công	attack, offensive, assault
tấn công bất ngờ	sudden attack
tán dóc	gossip, chatty
tàn nhẫn	ruthless
tàn phá	ravage
tản ra	scatter
tần số	frequency
tận tâm	devote
tán thành	concur, agree with
tận thế	end of the world
tán thưởng	applaud
tấn tới	improve, step forward 
tân ước	new testament
tang	mourning, death
tăng	surge, increase
tầng	deck
tảng	slab, block
tạng	diathesis
tăng 	increase
tảng băng	glacier
tâng bốc	flatter
tăng huyết áp	hypertension
tăng lên	rise
tầng lớp	grade, class, category
tăng tốc	accelerate
tàng trữ	store, include
tăng trưởng	grow, increase
tanh	tire-hoop
tánh	personal traits
tao	i, me
táo	apple
tảo	alga
tao 	I/me (superior)
tạo 	create
táo bạo	audacious, bold
tảo biển	algae
tạo ra	create, generate
táp	snap
tạp	poor, miscellaneous
tập	section
tập 	practice
tập ảnh	album
tạp chí	journal
tập hợp	gather
tập hợp lại	assemble
tạp nham	disparate
tập sự	probation
tập tin	file
tập trung	focus, concentrate
tập viết	writing
tát	slap
tất	socks
tắt	to switch off, to turn off
tật	blemish
tất cả	all
tất cả mọi thứ	everything
tật nguyền	handicap
tất nhiên	of course
tàu	train, large ship; Chinese
tẩu	opium pipe
tàu bay	aircraft
tàu chạy bằng hơi nước	steamer
tay	hand; a person (classifier)
tày	blunt-edged, to compare
tây	west
tẩy	to wipe out, to wipe off, to rub out (off)
tay áo	sleeve
tay bắt chó	dog-buster
tẩy não	brainwash
tay phải	right hand
tay trái 	the left hand
tẩy xóa	erase
tế	to run (ride at full gallop); to sacrifice, to worship
tệ	evil, social evil
tê 	numb
tệ 	bad, poor (situation, action)
tệ hơn	worse
tẻ nhạt	bland taste, uncaring feeling
tê tái 	numb deeply
tem	stamp
tên	name
tên cướp	bandit
tên hiệu	alias
tên lửa	missile
tên miền	domain
tên tội phạm	criminal
teo	shrink, reduce in size
tết	vietnamese lunar new year
tha	absolution
thà	rather
thả	to set free, to release, to let out
tha bống	pardoned
tha lỗi	excuse
tha thứ	forgive
tha tội	acquit, forgive
thả xuống	airdrop
thác	water rapid, waterfall
thác nước	waterfall
thạch cao	plaster
thách chiến	defy
thách thức	challenge
thai	fetus
thải	to discard, to eliminate, to discharge
thái cố	primeval
thái độ	attitude
thái nhỏ	mince
thai sản	maternity
tham	greedy; avaricious
thám	to spy
thăm	visit
thấm	to absorb, to suck
thầm	secret sneaking
thắm	deep, gorgeous
tham 	greedy, join
thầm 	silently
thậm chí	even as
tham chiếu	refer
thẩm định	appraisal
thăm dò	survey
thăm dò ý kiến	poll
tham dự	attend
tham gia	join, participate
thảm khốc	catastrophic, dire
thảm kịch	tragedy
thầm lặng	mute
thẩm mỹ	aesthetic, cosmetic
thâm nhập	penetrate
tham nhũng	corruption
thấm nước	absorbent
thẩm phán	judge
tham quan	sightseeing
thẩm quyền	authority
thẩm tách	dialysis
tham vấn	consult
tham vọng	ambition
thân	self, body
thần	god
thận	kidney
than 	to complain, charcoal
thần 	angel
thận 	kidney
thân cây	tree stalk, trunk
thần học	theology
thần kinh	nerve
thân mật	intimate, amicable
thân nhân	kin
thần thánh	divine
than thở	whine
thần thoại	myth
thận trọng	caution, cautious, deliberate
thần tượng	idol
than van	wailing
than vãn	whine
than vãn 	lament, moan and complain
thân xác	body
thân yêu	dear
thang	ladder
tháng	month
thăng	to promote
thằng	guy (degoratory)
thẳng	straight
thang 	ladder, portion (medicine)
tháng ba	March
tháng bảy	July
tháng chín	September
thẳng đứng	vertical
tháng hai	February
thằng hề	a clown, a fool
thang máy	lift
tháng một	January
tháng mười	October
tháng mười hai	December
tháng mười một	November
tháng năm	May
thằng ngốc	idiot
thằng nhóc	rogue
tháng sáu	June
tháng tám	August
thẳng thắn	candid, frank, outspoken
tháng tư	April
thanh	bar; tone, pitch; slat, piece, lear,
thánh	saint, holy
thành	becomes, (fort)
thanh 	elegant; rod, bar (window, iron, wood)
thanh bình	serene, peaceful
thành công	successful
thành hôn	married
thành kiến	prejudice
thánh kinh	bible
thành lập	constitute, establish
thành ngữ	idiom
thanh niên	young adult (17+), adolescent
thành phần	component
thành phố	municipal, city
thành ra	as it is
thanh tao	gracious
thanh thiếu niên	youths (teenager+)
thanh tra	inspect
thành từng mảnh	apart
thành viên	member
thao	coarse silk
thảo	to write, to draft
tháo 	remove
thảo luận	discuss
tháp	tower
thấp	low
thắp	to light, to burn
thập	10, cross (symbol)
thấp hơn	lower
thập kỷ	decade
thấp nhất	least
thập niên	10 years, decade
thắp sáng	lit
tháp tùng	accompany
thắt	constrict, fasten, tighten
thật	genuine, real
thất 	seven, to lose
thật 	real, truth
thất bại	failure, fail, defeat
thắt chặt	knotty
thất thường	capricious
thất vọng	disappoint(ment)
thau	brass
thầu	bid
thay	to replace, to substitute
thấy	see, witness, feel 
thầy	teacher, master,
thảy	all, every
thầy 	teacher
thầy bói	fortune teller
thay đối	modify, vary, change, alter
thầy giáo 	teacher
thây ma sống lại	zombie
thay thế	replace, alternate
thay vì	instead
thấy 	to see
thế	that
thề	vow
thẻ	card
thể	state; genre; aspect
thề 	swear
thể chất	physical
thể dục	exercise
thể dục nhịp điệu	aerobic
thế đứng	footing
thế giới	globe, world
thế hệ	generation
thể hiện	show, express
thế kỉ	century
thế kỷ	century
thê lương	dreary
thế nào	how
thế nào?	how?
thẻ tên	name card
thể thao	athletic
thê thiếp	concubine
thèm	to crave for
thêm	more, add, extra
thềm	veranda floor
thèm muốn	covet
thềm sân khấu	stage floor
thêm vào	additional
thẹn	shy
thèn thẹn	shy(ly)
theo	follow, according to
theo cách hóa học	chemically
theo dõi	trace, track
theo đuối	pursue
theo gương	imitate/follow example
thép	steel
thét	shriek
thết	to entertain, to treat to a feast
thêu	to embroider
thi	exam
thí	to risk, to sacrifice
thì	prime of youth
thị	decandrous persimmon
thì 	then
thì thầm	whisper
thị trấn	town
thị trấn 	town
thị trường	market
thị trưởng	mayor
thìa	spoon
thích	like, enjoy, fond, prefer
thích đáng	adequate, fitting
thích hợp	applicable, appropriate, compatible
thích nghi	adapt
thích thú	delighted
thích ứng	adapt
thiếc	tin
thiên	section, part
thiền	meditate
thiện	good, kind
thiện 	good nature and friendly
thiển cận	insular
Thiên Chúa	God above
thiên đỉnh	zenith
thiền định	meditated
thiên đường	heaven, paradise
thiên nhiên	nature
thiên tai	calamity
thiên tài	genius
thiên thần	angel
thiên văn học	astronomy
thiên vị	partial
thiêng liêng	sacred, divine
thiếp	card (visiting, wedding, invitation); (old literature)i/you for romantic female person
thiếp 	I/me/you for female romantic address (literary); card
thiết	to care for
thiệt	real, true
thiết bị	appliance, accessories
thiệt hại	damage
thiết kế	design
thiết lập	set(up), defined
thiết yếu	essencial
thiếu	deficient, lack
thiếu hấp dẫn	undesirable
thiếu kiên nhẫn	impatient
thiếu kinh nghiệm	inexperience
thiếu máu	anemia
thiếu nhẩn nại	impatience
thiếu niên	teenager
thiểu số	minority
thím	aunt (wife of father's younger brother)
thinh	silent, mum
thỉnh	to invite politely
thịnh	prosperous, thriving
thính giác	auditory
thính phòng	auditorium
thịnh vượng	prosperous
thịt	flesh, meat
thịt ba rọi	bacon
thịt bò	beef
thịt cừu	lamb
thịt lợn	pork
thịt quay	roast
thịt viên	meatball
thiu	to get stale
thô	rough, coarse
thỏ	rabbit
thơ	poetry; verse
thọ	to live long, to live to be
thờ	to worship
thở	breathe
thợ	workman
thơ 	verse
thơ ấu	childhood
thợ cắt tóc	barber
thợ chụp ảnh	cameraman
thở dài	sigh
thố dân	indian
thở hốn hển	pant, gasp
thô kệch	uncouth
thợ lặn	diver
thô lỗ	boorish, rude
thợ may	tailor
thợ mỏ	miner
thợ mộc	carpenter
thờ ơ	indifferent, apathetic
thợ rèn	blacksmith
thỏ rừng	hare
thô sơ	primitive
thơ thẩn 	wander
thô thiển	raw, backward, primitive
thợ thủ công	craftsman
thỏa hiệp	compromise
thoái hóa	degrade, retrogress, degenerate
thoải mái	comfortable
thoải mái 	comfortable, relax
thoảng	in a hint, a whiff of;
thoáng khí	airy
thoáng qua	brief glance/moment
thoát	escape
thoát 	escape
thóc	paddy
thọc	thrust, poke
thọc lét	tickling
thoi	to plunge, to fetch
thói	habit, practice
thôi	stop
thối	stink, rot
thỏi	bar
thổi	blow
thời	the time(once)
thói 	common practice, habit
thôi 	stop
thời 	time indicator
thời điểm	moment
thời đoạn	period
thời gian	time
thời gian 	time
thời gian cũ	old-time
thời hạn	deadline
thời kỳ quá độ	transitional period
thói quen	habit
thối rữa	decay
thời thanh niên	youth
thôi thúc	prompt
thời tiết	weather
thời trang	fashion
thối tù và	bugle
thôi việc	demit
thơm	fragrant, sweet-smelling
thốn thức	half-sob, fill with emotion
thông	to clear off, to unchock, to unclog to open
thông báo	notify, inform, notice
thông dâm	adultery
thông minh	smart, clever
thống nhất	unify
thông qua	adopt, approve, pass through
thong thả	leisurely
thông thạo	masterful, fluent
thông thường	usual
thông tin	information
thống trị	dominate
thốt ra	blurt
thu	collection
thú	pleasure, interest animal, beast, mammal
thù	hatre
thư	mail, letter
thứ	order, rank
thử	attempt, try
thư 	letter
thụ 	to receive
thử 	try
thứ ba	tuesday, third
thứ bảy	saturday, seventh
thứ chín	ninth
thú cưng	pet
thù địch	hostile
thủ đô	capital
thủ đoạn	devious
thụ động	passive
thư giãn	relax, chill
thử giọng	audition
thứ hai	Monday, the second
thu hẹp	narrow
thu hoạch	harvest
thu hồi	withdraw
thu hút	lure, attract
thư ký	clerk, secretary
thư ký bàn giấy	clerk
thủ lĩnh	leader
thư mục	bibliography
thứ mười	tenth
thứ mười hai	twelfth
thứ năm	fifth, Thursday
thu ngân	cashier
thử nghiệm	trial
thu nhập	income
thứ nhất	first
thu nhỏ lại	dwindle
thủ phạm	culprit
thứ sáu	sixth, friday
thứ tám	eighth
thụ thai	conceive
thu thập	collect
thu thập dữ liệu	collect documents
thủ thuật	trick
thủ tiêu	assassinate, murder
thú tội	confess
thứ tư	fourth, Wednesday
thủ tướng	prime minister
thư viện	library
thu xếp trước	prearrange
thua	to lose, to be defeated
thưa	to complain to, to report to
thừa	to comply with
thua 	lose, defeated
thừa 	excess
thừa kế	heir, inherit
thừa nhận	concede, admit
thừa nhận được	admissible
thuần	tamed, meek
thuận	favourable
thuần chủng	pure bred
thuần hóa	tame
thuật	method; to tell
thuật giả kim	alchemy
thuật viết chữ đẹp	calligraphy
thức	awake
thực	true, real
thúc 	to push, pester
thức 	wake
thực 	real, truth
thúc đẩy	promote
thực hành	practice
thực hiện	perform, execute
thực phẩm	food
thực tế	factual, actual, practical, realistic
thực thi	enforce
thực vật	botanic, plants, vegetables
thực vật học	botany
thuê	rent, hire, employ
thuế	tax
thuế quan	tariff
thụi	to hit, to plunge
thùng	crate, bucket, cask, barrel
thùng đánh kem	churn
thung lũng	valley
thùng rác	dustbin, garbage bin, wastebasket
thùng tròn	barrel
thuở	time, age, period
thuốc	medicine, medication, chemical solution
thuộc	belong, related to
thước	metre
thước Anh	yard
thuộc chó	canine
thuộc cơ thể	corporal
thuộc đám cưới	bridal
thuộc địa	colony
thuộc điện	electric
thuộc điền kinh	athletic
thuộc động mạch	arterial
thuộc giải phẫu	anatomic
thuốc giảm đau	pain killer
thuộc học thuật	academic
thuốc lá	cigarette
thuộc Mễ Tây Cơ	Mexican
thuốc mỡ	ointment
thuốc ngủ	barbiturate
thuốc nhuộm	dye
thuốc tẩy	bleach
thuộc trời	celestial
thuộc Trung Quốc	chinese
thuộc tuối 	of age
thuộc về	belong to, relate to
thuộc về bò	bovine
thuộc về chủng tộc	racial
thuộc về cơ khí	mechanical
thuộc về mặt trời	solar
thuộc về Mỹ	american
thuộc về tim	cardiac
thuộc về tố tiên	ancestral
thuốc viên	pill
thương	love; to care tenderly
thường	often, usually, normal
thưởng	bonus; to reward ; to award
thượng	upper, above
thường dân	civilian
thượng đế	deity
thương hại	compassionate
thương hiệu	brand
thường hơn	oftener
thương mại	relate to commerce, trade
thượng nghị sĩ	senator
thượng nghị viện	senate
thượng tá	colonel
thương tiếc	mourn
thường xuyên	regular, frequent
thút thít 	whimper
thủy	aquatic
thủy triều	tide
thuyền	boat
thuyền 	boat
thuyền buồm	sailboat
thuyền trưởng	captain
thuyền trưởng 	ship captain
thuyết	school of thought, philosophy
thuyết phục	compel, convince
tì	flaw, defect
tỉ	billion
tí 	little, a bit
tỉ mỉ	thorough
tia 	ray
tích	to store up, to accumulate
tích cực	positive
tích lũy	accumulate, gather
tích tụ 	accumulate, gather
tiếc	to regret, to be sorry
tiệc	banquet, party
tiệc đứng	buffet
tiêm	injection
tiềm ẩn	latent
tiềm năng	potential
tiềm tàng 	hidden potential
tiên	first
tiến	advance
tiền	money
tiễn	send off, saying goodbye
tiện	convenient, proper
tiên 	first, angel
tiến 	march forward, advance
tiến bộ	advance, progress
tiền chuộc	ransom
tiến độ	progress
tiện dụng	handy, useful
tiền gửi	deposits
tiến hành	proceed
tiền hoa hồng	commision
tiền lương	wage, salary
tiền mặt	cash
tiện nghi	comfort
tiền nhiệm	precious, fore
tiền nợ khất lại	arrear
tiền phạt	fine
tiến sỹ	doctorate
tiến thoái lưỡng nan	dilemma, difficult situation where any changes will have negative impact
tiền tố	prefix
tiền trợ cấp	bounty
tiền tuyến	battlefront
tiếng	sound
tiếng Anh	english
tiếng ồn	noise
tiếp	to procede, continue
tiếp biến về văn hóa	acculturate
tiếp cận	approach
tiếp giáp	contiguous
tiếp nhận	admitting
tiếp theo	next
tiếp tục	continue, resume
tiết	to secrete, to emit
tiết kiệm	save
tiết lộ	reveal, divulge
tiệt trùng	aseptic
tiêu	spend, used up; pepper
tiểu	small; minor; to urinate
tiêu chí	criteria
tiêu chuẩn	standard
tiêu cực	negative
tiêu đề	title
tiêu điểm	focal point
tiêu diệt	extermination
tiểu đường	diabetic
tiêu hóa	digest
tiểu học	primary
tiểu sử	biography
tiêu thụ	consume
tiểu thuyết	novel
tim	heart
tìm	find
tìm kiếm	seek, search
tim mạch	cardiovascular
tim mạch học	cardiology
tín	loyalty; faithfulness
tín dụng	credit
tin mừng	good news
tín ngưỡng	creed
tin nhắn	message
tin tức	news
tin tưởng	trust
tinh	sharp (mind)
tính	to calculate; character; nature of 
tình	love, bond, relationship
tĩnh	quiet, calm, tranquil
tỉnh	province
tính 	personality trait, character; to calculate
tĩnh 	awaken, serenity
tính a xít	acidic
tình anh em	brotherhood
tình bạn bè	felowship
tình cảm	affection
tinh chế	refine
tính chung lại	in summary
tình cờ	accidental
tình đồng bạn	fellowship
tĩnh dưỡng	rest/recoup in quiet
tỉnh giấc	wake up
tình hình	situation
tình hữu nghị	amity
tính khí	temper
tinh khiết	pure
tính kiêu căng	vanity
tĩnh mạch	vein
tính năng	feature
tính nghịch từ	diamagnetism
tình nguyện viên	volunteer
tỉnh táo	sober
tinh tế	exquisite
tinh thần	of mental/mind/spirit
tỉnh thức	arousal
tính toán	calculate, compute
tình trạng	condition, situation, state of (noun)
tình trạng hỗn loạn	anarchy, chaos
tình trạng thường xuyên vắng mặt	absenteeism
tính trung thực	fidelity
tính từ	adjective
tinh vi	delicate
tình yêu	love
tivi	television
tô	to colour, to trace; a big bowl
tố	nest
tỏ	to express, to show
tơ	silk, thread
tớ	i, me (amicable); a maid
tờ	sheet, classifier for sheet-like objects
tờ báo	newspaper
tố cáo	denunciate, accuse
tố chức	organization
tố chức giám sát	watch group
tô điểm	grace
tố giác	denounce, accuse
to lớn	huge
tơ lụa	silk
tò mò	pry, curious
tố ong	beehive
tố phụ	fathers
tờ rơi quảng cáo	brochure
tố tiên	ancestor, forebear
toa	train board/section
tỏa	to emit, to send out
tỏa 	radiate, spread
tòa án	court
tỏa rộng	the wide spread
tỏa sáng	shine, aglow
toa xe chở hàng	wagon
toạc	opened out
toan	to intend
toán	mathematic; a gang, group
toàn	whole
toàn bộ	whole, entire
toàn cầu	global, universal
toàn cầu này	this whole globe
toán học	mathematic
toàn thế giới	cosmopolitan
toan tính	plan, attempt, plot
tóc	hair
tộc	a family tribe
tốc độ	speed
tóc giả	wig
tóc ở cố	neck-hair
toe toét	huge grin
toét	to gape/cut open
tôi	i, me, mine(when follow noun)
tối	dark(ness), night
tỏi	garlic
tới	to come, to arrive, to reach
tội	sin, crime
tồi 	bad, lowlife
tội ăn trộm	burglary
tối cao	supreme
tôi chăm tôi học	I am diligent at learning
tôi cố tôi học	I strive to learn
tối đa	at most, maximum
tôi đi học	i go to learn/ i attend school
tội lỗi	sin, guilt
tối mờ mờ	dim
tội nhẹ	misdemeanor
tội phạm	crime
tối quan trọng	imperative
tôi sẽ	I will
tơi tả 	haggard, weary and torn
tồi tệ nhất	worst
tối thiểu	minimum
tới trước	forth
tôi xin lỗi	I'm sorry
tóm	to nab, to catch
tôm	shrimp
tởm	disgusting
tóm tắt	brief summary
tôn	to raise (status level)
tốn	to pay for
tợn	fierce
tốn 	cost, expense, pay
tôn giáo	religion
tôn nghiêm	sanctuary, holy, spiritual
tôn sùng	awe
tồn tại	exist, survive
tôn thờ	worship
tốn thương	damage, hurt
tôn trọng	respect
tống 	total, summary, gross
tổng cộng	total
tống hợp	sum, comprehensive
tống số	total
tốt	good, fine, well
tột cùng	ultimate
tốt hơn	better
tốt nghiệp	graduate
tốt nhất	best
tra	to fit in, to inspect
trá	disguised
trà	tea
trả	pay; to return, to give back
tra 	investigate
tra cứu	burrrow
trã đũa	get even, retaliate
trả lại	repay, pay back, render
trả lời	respond, answer, reply
tra tấn	torture
trả thù	revenge
trả tiền	pay
trắc	rosewood, kingwood
trách	to reproach for, to blame
trách 	blame
trách nhiệm 	responsibility
trai	young man, boy
trái	left
trải	to spread, to lay; to stretch out
trại	camp
trãi 	experiencing
trái cây	fruit
trái đất	earth
trải giường	bedspread
trái ngược	opposite
trái ngược nhau	opposite each other
trải ra	spread
trái tim	heart
trăm	hundred
trẫm	(literary) i (used by the king)
trạm	station
trầm ngâm	muse
trầm tích	sediment
trán	forehead
tràn	to overflow, to flood
trấn	town; restrain
trần	bare; ceiline
trận	battle, fight
trán 	forehead
tràn 	overflow
trận 	battle, attack of
trấn ải	defending frontier
trấn an	reassure
trận chiến	battle
trận đánh	battle
tràn ngập	overwhelm
trần nhà	ceiling
tràn qua	overflow
trần truồng	naked
trần tục	crude, earthly, mundane
trang	a page
tráng	to rinse, to coat a layer on
tràng	string of (sound); (old language) school
trăng	moon
trắng	white
trang điểm	makeup, decorate
trang nghiêm	solemn
trang phục	outfit, costume
trang trại	farm, ranch
trang trí	adorn, decorate
trạng từ	adverb
trang viên	manor, estate
trang web	web page
tranh	to compete, to fight for
tránh	avert, avoid, detour
tranh cãi	controversy
tranh chấp	dispute
tranh đấu	compete
tranh đua	rival
tranh luận	dispute, debate
trao 	hand over, exchange
trao đối	exchange
trao đối hàng hóa	barter
tráp	casket
trật 	wrong
trật tự	orderly
trâu	buffalo
trầu	betel
trầy	scratch
trầy xước	scratched
tre	bamboo
trễ	late
trẻ	young, junior
trễ 	late
trẻ con	child(ish)
trẻ em	young children
trẻ hơn	younger
trẻ mồ côi	orphan children
trẻ sơ sinh	newborn, infant
trệch	off track
trên	on, upon, above, upper
trên ấy	whereupon
trên đầu	overhead
trên đĩnh	on top
trên không	in the air
trên mặt đất	aboveground
trên tầng	on level
trên trời	in the sky
treo	hang
trèo	climb, mount, ascend
trêu	to tease; to nettle
trêu chọc	tease
trêu ngươi	tantalize
trí	mind
trị	to treat, to cure
trì 	sag down
trì hoãn	delay, postpone
trí nhớ	memory
trí thông minh	intelligence
trí tuệ	wisdom
trích	to extract, to take excerpts
trích 	extract
trích dẫn	citation, quote
triển khai	deploy
triển lãm	exhibit(ion)
triết	philosophy
triết học	philosophy
triều	dynasty; reign; tide; flood
triệu	million
triều đại	reign
triều xuống	ebb
trình	to submit, to show, to present, to report
trinh 	virgin
trình bày	present
trình diễn	perform
trình diễn đầu tiên	debut
trinh nữ	virgin female
trình tự	sequence
trìu mến	affectionate
tro	ash
trò	trick
trỏ	to point, to indicate
trở	to turn; to change
trợ cấp	allowance
trò chơi	game
trò chuyện	converse
trò đùa	prank, joke
trố hoa	blossom
trở lại	go back, return
trở lên	upward
trợ lý	assistant, aide
trở ngại	impediment
trở thành	become
trơ tráo	barefaced
trơ trẽn	brazen
tróc	to scale off; to come off
tróc 	peel off
trói	to rope, to tie, to bind
trôi	to drift, to float along
trời	sky
trội	dominant, superior
trói 	to tie
trôi 	to drift, float
trỗi 	to rise
trôi dạt	drift
trộm	theft
trộm 	theft, burglar
trộm cắp	theft, burglary
tròn	round
trôn	the bottom of a cup or bowl
trốn	hide, escape
trơn	slippery
trọn	fully, completely; entirely; all
trộn	mixed
tròn 	round
trốn 	hide, sneak
trong	in, within
trông	to mind, to look after
trống	vacant, blank, empty; drum
trồng	to grow, plant
trỌng	to think high of, to hold in esteem
trông 	look
trống 	blank
trồng cây	plant tree, planting
trọng điểm	key point
trong khi	while
trong khoảnh khắc	instantly
trong lúc	during
trọng lượng	weight
trông mong	expectant
trong nhà	indoor
trông nom	care taking, tend, look after
trong nước, nội địa	domestic
trong óc	mentally
trống rỗng	empty
trong số	among
trong suốt	throughout
trọng tài	umpire
trót	by mistake; accidentally
tru	howl
trú	reside, stay
trừ	to eliminate, to liquidate
trụ cột	pillar
trừ sâu	pesticide
trụ sở chính	headquarter
trưa	midday, noon
truất quyền	disqualify, overthrow
trúc	small bamboo, invory bamboo, reed
trục	axis
trực	to be on duty
trục đứng	pivot
trực tiếp	direct
trục trặc	blockage
trực tràng	rectum
trục xe	axle
trục xuất	banish, deport
trụi	naked, bear (chicken without feather, burnt all)
trùm	to cover,to put on
trung	mid, medium
trùng	coincide; same; an earthworm
trũng	depressed, sunken, hollow
trừng	to glower, to glare at
trừng 	stare
trung bình	average
trưng dụng cho quân đội	commandeer
trùng khớp	coincidental
trung lập	neutral
trung niên	middle aged
trừng phạt	punish
Trung Quốc	China
trung sỹ	sergeant
trung tâm	centre, central, center
trung thành	loyal
trung thực	honest
trùng với	coincide
trước	front, prior, before, ahead
trước đây	before, in front
trước khi	before
trước tiên	first
trườn sang	scramble
trương	to swell, to be bloated
trường	school; field
trưởng	chief
trưởng 	chief
trường công	public school
trường học	school
trường hợp	case, instance
trương lên	bloat
trường mẫu giáo	kindergarden
trưởng thành	grown-up, mature
trường tiểu học	elementary school
trường tư	private school
trượt	glide, slide, slip
trượt bánh	skid
trút	devolve
truy	to pursue, to seek, to inquire (into)
truy cập	access
truy tố	prosecute
truyền	circulate, transmit; pass down to
truyện	story
truyền cảm hứng	inspire
truyền đạt	convey, transfer (knowledge, power...)
truyền giáo	missionary
truyền thống	tradition
truyền tin	communicate
tu	to improve (mind, structure)
tù	prison; to shell
tủ	cabinet
tư	four, fourth
tụ	reassemble, gather together
tứ	four
từ	since, from; word
tử	death
tự	since, from
tù 	prison, jail
tụ 	converge, gather, meet
tứ 	four
tự bản thân	self rely
từ bắt đầu	onset, from beginning
từ bỏ	abdicate, renounce, waive
tư cách	virtue, character
tự cao	arrogant, think highly of self
tự cao tự đại	egotistical
tứ chi 	limbs, four parts of body
từ chối	reject, deny, refuse
từ chức	resign
tử cung	womb
tự đại	arrogant, think grandly of self
từ điển	dictionary
tự do	liberty, freedom
tự động	automatic
từ giã	farewell
tự giác	self aware
tự hào	proud
tụ hợp	congregate
tự làm	homemade
tủ lạnh	refrigerator
tự nguyện	voluntary
tư nhân	private
tự phát	spontanous
từ phía 	from direction
tự phụ	cocky
tủ quần áo	closet
tủ sách	bookcase
tư thế	posture
tư thế đĩnh đạc	poise
tử thi	cadaver
từ thiện	charity
tự tin	confident
từ tốn	demure
từ trần	depart life, pass away
tư vấn	advise, consult
tự vệ	defensive
tu viện	abbey
tu viện trưởng	abbot
từ vựng	vocabulary
tựa	title topic; lean on; such as
tựa trên vật gì	recline
tuần	week
tuân 	compliant, follow order
tuần này	this week
tuân phục 	obedient and subordination
tuân theo	obey, adhere, comply
tuân thủ	abide, comply, follow and enforce order
tuần trăng mật	honeymoon
tục	vulgar
tức	inside pressure; upset
tức giận	angry
tức là	which means
tức thì	instant
tức thời	instant
túi	pocket, pouch, bag
tùm	with a plop
tụng	to chant
từng	each
tung 	to launch, throw
từng nét một	one stroke at a time
tước	strip, cut off, remove from
tước bỏ	divest, deprive, remove from
tước đoạt	seize
tuối	age
tươi	fresh
tưới	water, to irrigate, to sprinkle
tuối dậy thì	puberty
tươi sáng	bright
tuối thơ	childhood
tuối trung niên	middle age
tuối trưởng thành	adulthood
tuồng	sort, kind
tương	soybean jam; thick soy sauce
tướng	general
tường	wall
tưởng	to think
tượng	statue
tường 	wall
tượng đài	monument
tương đương	equivalent
tương lai	future
tương phản	contrast
tượng sáp	waxwork
tương thích	compatible
tương tự	similar, alike
tưởng tượng	imagine
tương xứng	matching, compatible
túp lều	hut, tent
tụt	lag, fall behind
tuy	although
tùy	depending
tủy	marrow
tụy	pancrea, pancreatic
tùy chỉnh	custom
tùy chọn	option
tùy nghi	discretionary
tuy nhiên	though, however
tùy theo	depending on
tùy theo điều kiện nào	whichever
tùy ý	discretion
tuyên bố 	announce, declare
tuyển dụng	recruit
tuyển tập văn thơ	anthology
tuyên thệ	oath
tuyết	snow
tuyệt	fabulous; extreme; terminating (an action)
tuyết 	snow
tuyệt 	great
tuyệt chủng	extinct
tuyết đã rơi	snowed
tuyệt đối	absolute
tuyết lở	avalanche
tuyết rơi	snowfall
tuyết trắng	snow-white
tuyệt vời	excellent, amazing
tuyệt vọng	forlorn, desperate, despair
tỷ	billion
tỷ lệ	proportion
tỷ lệ phần trăm	percentage
ù	fast, swiftly; chubby round size
ủ	brew, incubate
u ám	gloom
u buồn	morose
ủ dột 	sullen and gloomy
u nang	cyst
u sầu	melancholy
u tuyến	adenoma
úa	brown; waning
ưa	be fond of, like
ức	to choke with anger; the chest
uế	dirty wastes
uể oải	slack
ủi	to iron
um tùm	bushy, thick wooded
um tùm cỏ dại	weedy
ung	rot
ứng cử	candidacy
ứng cử viên	candidate
ung dung	cavalier
ủng hộ	favor, advocate, supportive
ứng nghiệm	fulfilled
ung thư	cancer
ứng viên	applicant
ước	to wish
ước lượng	estimate
ước nguyện	desideratum
ước tính	computation
ươn	spoil
uốn cong	bend
uống	drink
uống 	drink
ướt	wet
úp	to upturn, to turn over
ưu thế	advantage
ưu tiên	priority
ủy ban	committee
ủy mị	sentimental
ủy quyền	delegate
uy tín	prestige
vá	shovel, ladle; to mend
và	and
vả	to slap
và 	and
va chạm	collide, bump into
vác	carry
vạc	to carve; a night heron(bird)
vách	wall
vạch	to draw, to point out, to outline
vách cao	high-walled
vách đá	cliff
vai	shoulder
vái	bow
vài	few
vải	canvas, cloth
vại	large container
vai 	shoulder
vải len thô	duffel
vải mỏng dính	sheer fabric
vải vóc	drapery
vạm vỡ	stout
vạm vỡ nhất	stoutest
van	beseech, plead
ván	board, plank
văn	literature
vấn	to wind; to roll
vần	rhyme; verse
vẫn	still
vạn	ten thousand
vận	destiny, fortune
vặn	twist
văn 	literature, writing
văn bản	text
vặn chặt	screw
vận chuyển	transport
vẫn còn	remain, is still
vấn đề	matter, problem
vận động chính sách	advocacy
vận động hành lang	lobby
vận động viên	athlete
vận hành	operate
văn hay 	writing well
văn hóa	culture
văn học	literature
văn minh	civilized, civilization
văn phòng	office
vận rủi	draught
vận tải hàng hóa	freight
văn thư lưu trữ	archive
vận tốc	velocity
vạn vật	all beings
vặn vẹo	wriggle
van xin	beg
vang	to echo
váng	film, scum
vàng	yellow(color); gold (metal)
vâng	yes, yep, yeah
vầng	crest
vắng	secluded
vang 	echo loudly
vàng hoe	blond
vâng lời	obedient
vắng mặt	absent
vàng nhạt	yellowish
vành	rim
vành đai	hoop
vào	enter, into, on
vào bàn	on the table
vào khi	at the time of
vào nơi	arriving at
vào trong	into
vấp	to trip, to stumble to flounder, to make (mistakes)
vắt	terrestrial leech
vật	material, object, item, thing
vặt	trifling, petty, odd
vất 	toss away
vật kèm theo	accompaniment
vật không tên	widget
vật liệu	material
vật lộn	toil, wrestle
vật lý	physics
vật thế chấp	collateral
vật tư	depot
vất vả	drudgery
vất vả 	hardwork, laboring
vay	borrow
váy	skirt, dress
vây	fin
vấy	smeared
vầy	so, this way, like this
vẫy	wave
vẩy	flake, scab
vậy	so then
vây 	fins, to surround
vẩy 	flake, skin scales, to wag
vậy 	so
vẫy cờ	flagged
vay mượn	loan
vay thế chấp	mortgage
ve	tick
vé	ticket
vẽ	draw
về	(to) go home, return to, about
vẻ	look, appearance, sound
vệ	edge, side
vẻ 	seems, appear
vê be	Weber
về đằng nội	paternal
về đêm	nocturnal
vẻ đẹp	beauty
về hướng đông	eastbound
về một bên	aside
về nhà	go/return home
về phía trước	forward
vệ sĩ	bodyguard
vệ sinh	sanitary
về sự	about
vệ tinh	satellite
ve vẩy 	wag
ven	fringe, edge
ven biển	coastal
véo	pinch
vết	stain, blot, trace
vết bẩn	taint, dirt
vết nứt	crack
vết sẹo	scar
vết thâm	bruise
vết thương	wound
ví	wallet,purse
vì	because
vị	taste
ví 	to compare; a wallet, purse
vì 	because
vĩ đại	great
vĩ độ	latitude
ví dụ	example
ví dụ 	for example
vi khuẩn	bacteria
vi phạm	breach, violate
vì sao	star; why
vi ta min	vitamin
vị thành niên	juvenile, minor
ví tiền	wallet of money
vị trí	position
vi trùng	germ
vỉa hè	veranda, sidewalk
việc	job, work
việc 	work, task
việc làm	work, task
việc làm có hại	misdeed
việc lặt vặt	chore, errand
việc phải làm	agenda
viêm	inflammation
viêm gan	hepatitis
viêm phế quản	bronchitis
viêm phối	pneumonia
viên	pellet
viền	edge
viện	department
viên 	pellet, a member of
viện bảo tàng	museum
viễn cảnh	prospect
viên chức	officer
viện lý do	make excuse
viện lý lẽ	make excuse
viện sĩ hàn lâm	academician
viện trợ	aid
viễn tưởng	fiction
viếng	visit
viết	write
việt	vietnamese
viết ngoáy	scrabble
viết tắt	abbreviate
viết thành kịch	dramatization
viết thêm vào	append
vĩnh cửu	eternal
vinh hạnh	honor
vinh quang	glory
vĩnh viễn 	permanent, forever
vịt	duck
vịt 	duck
vịt con	duckling
vịt đực	drake
vò	to crumple up, to crush up
vô	enter; negate word (un)
võ	wasted
vố	a blow, trick
vồ	to prey, catch
vỗ	to clap, slap
vỏ	shell
vơ	grab
vớ	sock
vờ	pretend
vỡ	mudguard
vở	notebook, classifier for story
vợ	wife
vỗ 	pat
vỡ 	to break
vỏ cây	bark
vô danh	nameless, unknown
vô đạo đức	immoral
vô địch	champion
vô định hình	amorphous
vô hạn	infinite
vô hiệu	vain, ineffective
vô hồn	lifeless
vô ích	useless
vở kịch cho sân khấu	drama
vô lý	absurd
vô nghĩa	nonsense, pointless
vò nhàu	crumple, make wrinkle
vỗ nhẹ	pat
vô số	countless
vô tận	endless
vỗ tay	clap
vô thần	atheist
vô tư	carefree
vô tư lự	unconcern
vỗ về	comfort, sooth
vóc	size, figure
voi	elephant
vói	reach
vòi	pleading
vôi	lime(stone), calcium oxide
với	with
vội	in a hurry, hasty
voi 	elephant
vội 	hurry, haste
vòi (nước)	tap
vòi hoa sen	showerhead
vòi nước	faucet
với tôi	with me
với tới	reach
vội vã 	hurry, hasty
vội vàng	hurry, hasty
vòm	cove, canopy
vốn	capital, bond, fund
vòng	circular, ring
võng	hammock
vọng	to echo, to resound
võng 	hammock
vọng 	to echo, expectations
vòng cố	necklace
vòng đeo tay	bracelet
vòng hoa	wreath
vòng tay	bosom
vòng tròn	circle
vớt	picked
vọt 	to leap to, spurt out
vú	breast
vụ	season, time
vụ 	service, the event of
vụ bê bối	scandal
vũ khí	weapon
vũ trụ	universe, cosmic
vua	king
vừa	fits
vừa 	just, fit
vừa khít	snug
vừa nói vừa trèo	said as he climbed
vừa phải	moderate
vừa qua	just passed
vực	chasm, abyss
vực 	to raise upward, recoup forcefully, the cliff
vực sâu	abyss
vui	fun, joy
vùi 	buried
vui chơi 	playing
vui mừng	glad
vui tánh	genial
vui thích	delectate
vui tươi	jubilant, joyous
vui vẻ	fun, zest, joy, jolly
vụn vặt	futile
vung	flowrish, brandish
vũng	puddle
vụng	clumsy
vững	firm, steady
vụng 	clumsy
vùng đất	region
vùng đất đầy mặt trời	sunland
vùng đất hướng nam	southland
vùng hoang vu	wilderness region
vũng nước	puddle of water
vụng về	awkward, clumsy
vuờn	garden
vườn	garden
vườn cây ăn quả	orchard
vườn cây ăn trái	orchard
vườn sau	backyard
vườn thú	zoo
vương	king
vướng	to be burdened
vượng	prosperous, thriving
vuông góc	perpendicular
vương miện	crown
vương quốc	kingdom
vuốt	to stroke, rub gently
vượt	cross
vượt qua	overcome, exceed, overtake
vuốt ve	fondle, caress
vứt 	throw away
xa	far, distant
xá	to salute, bow profoundly
xà	snake
xã	village
xả	discharge
xã hội	social, society
xa hơn	further
xa lánh	aloof
xa nhất	farthest
xà phòng	soap
xa xôi	quite far
xa xôi nhất	remotest
xác	corpse
xấc	impolite, rude and arrogant
xác chết	corpse
xác định	determine, affirm, certify
xác định vị trí	locate
xác suất	probability
xác tàu	wreck
xác ướp	mummy
xách	to carry by the handle
xách tay	hand carry, portable
xài	to spend the money, to use
xám	grey
xâm	to tatoo
xâm lược	invade
xám xịt	very gray
xăng	gasoline
xằng	unresonable, senseless, falsely, erroneously, wrongfully
xanh	green
xáo	stir up
xào	to stir-fry
xảo	artful
xảo quyệt	insidious, cunning
xát	rub
xấu	bad
xấu hố	shame, blush, ashamed
xâu thành chuỗi	strung
xấu xa	vicious
xấu xí	ugly
xay	grind
xây	building
xảy 	occur
xây dựng	construct, build, construct
xây ghép	bond
xảy ra	happen, occur
xe	vehicle
xé	rend, tear, rip
xe ba bánh	tricycle
xe buýt	bus
xe đạp	bicycle
xe đẩy	barrow
xe hơi	car
xe kéo	wagon
xe kéo trượt băng	sled
xe lăn	wheelchair
xe lửa	train
xe ngựa	chariot
xe ô tô	automobile
xe tải	truck
xe tăng	tank
xe taxi	cab
xem	look, see, watch, view
xem lại	review
xem thường	disparage, undervalue, take lightly
xem xét	observe, review
xem xét lại	review
xem, cảnh	view
xén	shear
xen kẽ	interlacing
xếp	collapsible
xếp hạng	rank
xét 	verify and review
xét xử	settle an issue
xỉ	cinder
xì hơi	deflate
xi măng	cement
xỉ nhục	dishonor, humiliate, to cause disgrace
xiết	tighten
xiêu	agreable
xiêu xiêu	leaning and agreable
xin	ask
xỉn	get hammered 
xin chào	hello
xin lỗi	sorry, apologize, excuse
xinh xắn	pretty
xịt	spray
xó	corner
xô	shove, push
xố	rush into
xồ 	aggressive stance and leap forth, to hang all out
xô đẩy	barge
xố số	lottery
xoa	rub
xoá	remove; wipe, rub out
xóa 	delete, erase
xóa bỏ	abolish
xoa dịu	salve
xoắn	twist
xoắn ốc	spiral
xoăn rậm	Afro
xoàng	two-bits
xoay 	turn, twist
xoáy nước	whirlpool
xóc	to shake
xốc	to lift up
xoè	spread wide
xối	to pour down
xới	to turn up
xóm	hamlet
xong	finish, be complete
xông	exhale, to rush
xông 	steam sauna effect, sudden bold entrance
xông khói	smoked
xốp 	plush, foamy
xót	sting, smart
xót xa	deplore
xu	sou
xứ	region
xử	handle, solve, dispose, punish (problem)
xử lý	handle, solve, dispose (problem)
xử lý kỷ luật	to discipline
xứ ở miền bắc	northland
xử sự	comport
xù xì	rough, coarse
xưa	ancient
xưa kia	old
xua tan	dispel
xuân	spring
xuân 	xuan
xuất	production; to pay out
xuất 	initiate production
xuất hiện	appear
xuất khẩu	export
xuất quỷ nhập thần	fiend, like a magician
xuất sắc	top notch, excellent
xúc 	to shovel
xúc phạm	to violate, insult
xúc tác	catalystic
xuể	manageable
xúi giục	abet
xúm	gather, cluster
xung	impulsive
xứng	matching, fitting, of same level
xứng đáng	deserve, worthy
xung đột 	conflict
xung quanh	surrounding
xước	scratch
xuôi dòng	downstream
xuống	(go)down, descend
xương	bone
xướng	originate
xưởng	factory, mill, workshop
xương 	bone
xuống dốc	downhill
xương đòn	collarbone
xương gò má	cheekbone
xương sống	backbone
xương sườn	rib
xương xẩu	bony
xuyên 	through
xuyên qua	penetrate, through
xuyên tạc	spin, distort (information)
y	he, him
ý	idea
ỷ	to depend on
ý 	idea, meaning
ý định	intention
y học	study of medicine
ý kiến	opinion
ý nghĩ	thought
y phục	apparel
y tá	nurse
y tế	of health, medical
ý tưởng	idea
yếm	brassiere
yên	saddle
yên 	let alone, calm
yên bình 	calm and peaceful
yên tĩnh	quiet, peaceful
yên xe	saddle
yêu	love
yếu	weak
yêu cầu	demand, request
yêu mến	cherish, love
yêu quý	belove
yêu thích	favorite
yêu tinh	demon